Borowiec2015_Best108_Oikopleura_dioica	 Metazoa; Eumetazoa; Bilateria; Deuterostomia; Chordata; Tunicata; Appendicularia; Oikopleuridae; Oikopleura
Borowiec2015_Best108_Apis_mellifera	 Metazoa; Eumetazoa; Bilateria; Protostomia; Ecdysozoa; Panarthropoda; Arthropoda; Mandibulata; Pancrustacea; Hexapoda; Insecta; Dicondylia; Pterygota; Neoptera; Holometabola; Hymenoptera; Apocrita; Aculeata; Apoidea; Apidae; Apinae; Apini; Apis
Borowiec2015_Best108_Monosiga_brevicollis	 Choanoflagellida; Craspedida; Salpingoecidae; Monosiga
Borowiec2015_Best108_Salpingoeca_rosetta	 Choanoflagellida; Craspedida; Salpingoecidae; Salpingoeca
Borowiec2015_Best108_Tribolium_castaneum	 Metazoa; Eumetazoa; Bilateria; Protostomia; Ecdysozoa; Panarthropoda; Arthropoda; Mandibulata; Pancrustacea; Hexapoda; Insecta; Dicondylia; Pterygota; Neoptera; Holometabola; Coleoptera; Polyphaga; Cucujiformia; Tenebrionoidea; Tenebrionidae; Tenebrionidae incertae sedis; Tribolium
Borowiec2015_Best108_Tetranychus_urticae	 Metazoa; Eumetazoa; Bilateria; Protostomia; Ecdysozoa; Panarthropoda; Arthropoda; Chelicerata; Arachnida; Acari; Acariformes; Trombidiformes; Prostigmata; Eleutherengona; Raphignathae; Tetranychoidea; Tetranychidae; Tetranychus
Borowiec2015_Best108_Acropora_digitifera	 Metazoa; Eumetazoa; Cnidaria; Anthozoa; Hexacorallia; Scleractinia; Astrocoeniina; Acroporidae; Acropora
Borowiec2015_Best108_Hydra_magnipapillata	 Metazoa; Eumetazoa; Cnidaria; Hydrozoa; Hydroidolina; Anthoathecata; Aplanulata; Hydridae; Hydra
Borowiec2015_Best108_Acyrthosiphon_pisum	 Metazoa; Eumetazoa; Bilateria; Protostomia; Ecdysozoa; Panarthropoda; Arthropoda; Mandibulata; Pancrustacea; Hexapoda; Insecta; Dicondylia; Pterygota; Neoptera; Paraneoptera; Hemiptera; Sternorrhyncha; Aphidomorpha; Aphidoidea; Aphididae; Aphidinae; Macrosiphini; Acyrthosiphon
Borowiec2015_Best108_Danaus_plexippus	 Metazoa; Eumetazoa; Bilateria; Protostomia; Ecdysozoa; Panarthropoda; Arthropoda; Mandibulata; Pancrustacea; Hexapoda; Insecta; Dicondylia; Pterygota; Neoptera; Holometabola; Amphiesmenoptera; Lepidoptera; Glossata; Neolepidoptera; Heteroneura; Ditrysia; Obtectomera; Papilionoidea; Nymphalidae; Danainae; Danaini; Danaina; Danaus; Danaus
Borowiec2015_Best108_Caenorhabditis_elegans	 Metazoa; Eumetazoa; Bilateria; Protostomia; Ecdysozoa; Nematoda; Chromadorea; Rhabditida; Rhabditina; Rhabditomorpha; Rhabditoidea; Rhabditidae; Peloderinae; Caenorhabditis
Borowiec2015_Best108_Drosophila_melanogaster	 Metazoa; Eumetazoa; Bilateria; Protostomia; Ecdysozoa; Panarthropoda; Arthropoda; Mandibulata; Pancrustacea; Hexapoda; Insecta; Dicondylia; Pterygota; Neoptera; Holometabola; Diptera; Brachycera; Muscomorpha; Eremoneura; Cyclorrhapha; Schizophora; Acalyptratae; Ephydroidea; Drosophilidae; Drosophilinae; Drosophilini; Drosophila; Sophophora; melanogaster group; melanogaster subgroup
Borowiec2015_Best108_Nematostella_vectensis	 Metazoa; Eumetazoa; Cnidaria; Anthozoa; Hexacorallia; Actiniaria; Edwardsiidae; Nematostella
Borowiec2015_Best108_Amphimedon_queenslandica	 Metazoa; Porifera; Demospongiae; Heteroscleromorpha; Haplosclerida; Niphatidae; Amphimedon
Borowiec2015_Best108_Mnemiopsis_leidyi	 Metazoa; Eumetazoa; Ctenophora; Tentaculata; Lobata; Bolinopsidae; Mnemiopsis
Borowiec2015_Best108_Ixodes_scapularis	 Metazoa; Eumetazoa; Bilateria; Protostomia; Ecdysozoa; Panarthropoda; Arthropoda; Chelicerata; Arachnida; Acari; Parasitiformes; Ixodida; Ixodoidea; Ixodidae; Ixodinae; Ixodes
Borowiec2015_Best108_Trichoplax_adhaerens	 Metazoa; Placozoa; Trichoplacidae; Trichoplax
Borowiec2015_Best108_Xenopus_tropicalis	 Metazoa; Eumetazoa; Bilateria; Deuterostomia; Chordata; Craniata; Vertebrata; Gnathostomata; Teleostomi; Euteleostomi; Sarcopterygii; Dipnotetrapodomorpha; Tetrapoda; Amphibia; Batrachia; Anura; Pipoidea; Pipidae; Xenopodinae; Xenopus; Silurana
Borowiec2015_Best108_Fugu	 Metazoa; Eumetazoa; Bilateria; Deuterostomia; Chordata; Craniata; Vertebrata; Gnathostomata; Teleostomi; Euteleostomi; Actinopterygii; Actinopteri; Neopterygii; Teleostei; Osteoglossocephalai; Clupeocephala; Euteleosteomorpha; Neoteleostei; Eurypterygia; Ctenosquamata; Acanthomorphata; Euacanthomorphacea; Percomorphaceae; Eupercaria; Tetraodontiformes; Tetraodontoidei; Tetradontoidea; Tetraodontidae
Borowiec2015_Best108_Gasterosteus_aculeatus	 Metazoa; Eumetazoa; Bilateria; Deuterostomia; Chordata; Craniata; Vertebrata; Gnathostomata; Teleostomi; Euteleostomi; Actinopterygii; Actinopteri; Neopterygii; Teleostei; Osteoglossocephalai; Clupeocephala; Euteleosteomorpha; Neoteleostei; Eurypterygia; Ctenosquamata; Acanthomorphata; Euacanthomorphacea; Percomorphaceae; Eupercaria; Perciformes; Cottioidei; Gasterosteales; Gasterosteidae; Gasterosteus
Borowiec2015_Best108_Homo_sapiens	 Metazoa; Eumetazoa; Bilateria; Deuterostomia; Chordata; Craniata; Vertebrata; Gnathostomata; Teleostomi; Euteleostomi; Sarcopterygii; Dipnotetrapodomorpha; Tetrapoda; Amniota; Mammalia; Theria; Eutheria; Boreoeutheria; Euarchontoglires; Primates; Haplorrhini; Simiiformes; Catarrhini; Hominoidea; Hominidae; Homininae; Homo
Borowiec2015_Best108_Latimeria_chalumnae	 Metazoa; Eumetazoa; Bilateria; Deuterostomia; Chordata; Craniata; Vertebrata; Gnathostomata; Teleostomi; Euteleostomi; Sarcopterygii; Coelacanthimorpha; Coelacanthiformes; Coelacanthidae; Latimeria
Borowiec2015_Best108_Gallus_gallus	 Metazoa; Eumetazoa; Bilateria; Deuterostomia; Chordata; Craniata; Vertebrata; Gnathostomata; Teleostomi; Euteleostomi; Sarcopterygii; Dipnotetrapodomorpha; Tetrapoda; Amniota; Sauropsida; Sauria; Archelosauria; Archosauria; Dinosauria; Saurischia; Theropoda; Coelurosauria; Aves; Neognathae; Galloanserae; Galliformes; Phasianidae; Phasianinae; Gallus
Borowiec2015_Best108_Anolis_carolinensis	 Metazoa; Eumetazoa; Bilateria; Deuterostomia; Chordata; Craniata; Vertebrata; Gnathostomata; Teleostomi; Euteleostomi; Sarcopterygii; Dipnotetrapodomorpha; Tetrapoda; Amniota; Sauropsida; Sauria; Lepidosauria; Squamata; Bifurcata; Unidentata; Episquamata; Toxicofera; Iguania; Dactyloidae; Anolis
Borowiec2015_Best108_Ciona_savignyi	 Metazoa; Eumetazoa; Bilateria; Deuterostomia; Chordata; Tunicata; Ascidiacea; Enterogona; Phlebobranchia; Cionidae; Ciona
Borowiec2015_Best108_Strigamia_maritima	 Metazoa; Eumetazoa; Bilateria; Protostomia; Ecdysozoa; Panarthropoda; Arthropoda; Mandibulata; Myriapoda; Chilopoda; Pleurostigmophora; Epimorpha; Geophilomorpha; Linotaeniidae; Strigamia
Borowiec2015_Best108_Daphnia_magna	 Metazoa; Eumetazoa; Bilateria; Protostomia; Ecdysozoa; Panarthropoda; Arthropoda; Mandibulata; Pancrustacea; Crustacea; Branchiopoda; Phyllopoda; Diplostraca; Cladocera; Anomopoda; Daphniidae; Daphnia
Borowiec2015_Best108_Strongylocentrotus_purpuratus	 Metazoa; Eumetazoa; Bilateria; Deuterostomia; Echinodermata; Eleutherozoa; Echinozoa; Echinoidea; Euechinoidea; Echinacea; Echinoida; Strongylocentrotidae; Strongylocentrotus
Borowiec2015_Best108_Capitella_teleta	 Metazoa; Eumetazoa; Bilateria; Protostomia; Lophotrochozoa; Annelida; Polychaeta; Scolecida; Capitellida; Capitellidae; Capitella
Borowiec2015_Best108_Saccoglossus_kowalevskii	 Metazoa; Eumetazoa; Bilateria; Deuterostomia; Hemichordata; Enteropneusta; Harrimaniidae; Saccoglossus
Borowiec2015_Best108_Lottia_gigantea	 Metazoa; Eumetazoa; Bilateria; Protostomia; Lophotrochozoa; Mollusca; Gastropoda; Patellogastropoda; Lottioidea; Lottiidae; Lottia
Borowiec2015_Best108_Branchiostoma_floridae	 Metazoa; Eumetazoa; Bilateria; Deuterostomia; Chordata; Cephalochordata; Branchiostomidae; Branchiostoma
Borowiec2015_Best108_Pinctada_fucata	 Metazoa; Eumetazoa; Bilateria; Protostomia; Lophotrochozoa; Mollusca; Bivalvia; Pteriomorphia; Pterioida; Pterioidea; Pteriidae; Pinctada
Borowiec2015_Best108_Brugia_malayi	 Metazoa; Eumetazoa; Bilateria; Protostomia; Ecdysozoa; Nematoda; Chromadorea; Rhabditida; Spirurina; Spiruromorpha; Filarioidea; Onchocercidae; Brugia
Borowiec2015_Best108_Rhodnius_prolixus	 Metazoa; Eumetazoa; Bilateria; Protostomia; Ecdysozoa; Panarthropoda; Arthropoda; Mandibulata; Pancrustacea; Hexapoda; Insecta; Dicondylia; Pterygota; Neoptera; Paraneoptera; Hemiptera; Prosorrhyncha; Heteroptera; Euheteroptera; Neoheteroptera; Panheteroptera; Cimicomorpha; Reduvioidea; Reduviidae; Triatominae; Rhodnius
Borowiec2015_Best108_Bombus_terrestris	 Metazoa; Eumetazoa; Bilateria; Protostomia; Ecdysozoa; Panarthropoda; Arthropoda; Mandibulata; Pancrustacea; Hexapoda; Insecta; Dicondylia; Pterygota; Neoptera; Holometabola; Hymenoptera; Apocrita; Aculeata; Apoidea; Apidae; Bombinae; Bombini; Bombus; Bombus
Borowiec2015_Total1080_Salpingoeca_rosetta	 Choanoflagellida; Craspedida; Salpingoecidae; Salpingoeca
Borowiec2015_Total1080_Monosiga_brevicollis	 Choanoflagellida; Craspedida; Salpingoecidae; Monosiga
Borowiec2015_Total1080_Amphimedon_queenslandica	 Metazoa; Porifera; Demospongiae; Heteroscleromorpha; Haplosclerida; Niphatidae; Amphimedon
Borowiec2015_Total1080_Mnemiopsis_leidyi	 Metazoa; Eumetazoa; Ctenophora; Tentaculata; Lobata; Bolinopsidae; Mnemiopsis
Borowiec2015_Total1080_Ciona_savignyi	 Metazoa; Eumetazoa; Bilateria; Deuterostomia; Chordata; Tunicata; Ascidiacea; Enterogona; Phlebobranchia; Cionidae; Ciona
Borowiec2015_Total1080_Trichoplax_adhaerens	 Metazoa; Placozoa; Trichoplacidae; Trichoplax
Borowiec2015_Total1080_Branchiostoma_floridae	 Metazoa; Eumetazoa; Bilateria; Deuterostomia; Chordata; Cephalochordata; Branchiostomidae; Branchiostoma
Borowiec2015_Total1080_Nematostella_vectensis	 Metazoa; Eumetazoa; Cnidaria; Anthozoa; Hexacorallia; Actiniaria; Edwardsiidae; Nematostella
Borowiec2015_Total1080_Homo_sapiens	 Metazoa; Eumetazoa; Bilateria; Deuterostomia; Chordata; Craniata; Vertebrata; Gnathostomata; Teleostomi; Euteleostomi; Sarcopterygii; Dipnotetrapodomorpha; Tetrapoda; Amniota; Mammalia; Theria; Eutheria; Boreoeutheria; Euarchontoglires; Primates; Haplorrhini; Simiiformes; Catarrhini; Hominoidea; Hominidae; Homininae; Homo
Borowiec2015_Total1080_Fugu	 Metazoa; Eumetazoa; Bilateria; Deuterostomia; Chordata; Craniata; Vertebrata; Gnathostomata; Teleostomi; Euteleostomi; Actinopterygii; Actinopteri; Neopterygii; Teleostei; Osteoglossocephalai; Clupeocephala; Euteleosteomorpha; Neoteleostei; Eurypterygia; Ctenosquamata; Acanthomorphata; Euacanthomorphacea; Percomorphaceae; Eupercaria; Tetraodontiformes; Tetraodontoidei; Tetradontoidea; Tetraodontidae
Borowiec2015_Total1080_Gasterosteus_aculeatus	 Metazoa; Eumetazoa; Bilateria; Deuterostomia; Chordata; Craniata; Vertebrata; Gnathostomata; Teleostomi; Euteleostomi; Actinopterygii; Actinopteri; Neopterygii; Teleostei; Osteoglossocephalai; Clupeocephala; Euteleosteomorpha; Neoteleostei; Eurypterygia; Ctenosquamata; Acanthomorphata; Euacanthomorphacea; Percomorphaceae; Eupercaria; Perciformes; Cottioidei; Gasterosteales; Gasterosteidae; Gasterosteus
Borowiec2015_Total1080_Anolis_carolinensis	 Metazoa; Eumetazoa; Bilateria; Deuterostomia; Chordata; Craniata; Vertebrata; Gnathostomata; Teleostomi; Euteleostomi; Sarcopterygii; Dipnotetrapodomorpha; Tetrapoda; Amniota; Sauropsida; Sauria; Lepidosauria; Squamata; Bifurcata; Unidentata; Episquamata; Toxicofera; Iguania; Dactyloidae; Anolis
Borowiec2015_Total1080_Gallus_gallus	 Metazoa; Eumetazoa; Bilateria; Deuterostomia; Chordata; Craniata; Vertebrata; Gnathostomata; Teleostomi; Euteleostomi; Sarcopterygii; Dipnotetrapodomorpha; Tetrapoda; Amniota; Sauropsida; Sauria; Archelosauria; Archosauria; Dinosauria; Saurischia; Theropoda; Coelurosauria; Aves; Neognathae; Galloanserae; Galliformes; Phasianidae; Phasianinae; Gallus
Borowiec2015_Total1080_Latimeria_chalumnae	 Metazoa; Eumetazoa; Bilateria; Deuterostomia; Chordata; Craniata; Vertebrata; Gnathostomata; Teleostomi; Euteleostomi; Sarcopterygii; Coelacanthimorpha; Coelacanthiformes; Coelacanthidae; Latimeria
Borowiec2015_Total1080_Strongylocentrotus_purpuratus	 Metazoa; Eumetazoa; Bilateria; Deuterostomia; Echinodermata; Eleutherozoa; Echinozoa; Echinoidea; Euechinoidea; Echinacea; Echinoida; Strongylocentrotidae; Strongylocentrotus
Borowiec2015_Total1080_Danaus_plexippus	 Metazoa; Eumetazoa; Bilateria; Protostomia; Ecdysozoa; Panarthropoda; Arthropoda; Mandibulata; Pancrustacea; Hexapoda; Insecta; Dicondylia; Pterygota; Neoptera; Holometabola; Amphiesmenoptera; Lepidoptera; Glossata; Neolepidoptera; Heteroneura; Ditrysia; Obtectomera; Papilionoidea; Nymphalidae; Danainae; Danaini; Danaina; Danaus; Danaus
Borowiec2015_Total1080_Tetranychus_urticae	 Metazoa; Eumetazoa; Bilateria; Protostomia; Ecdysozoa; Panarthropoda; Arthropoda; Chelicerata; Arachnida; Acari; Acariformes; Trombidiformes; Prostigmata; Eleutherengona; Raphignathae; Tetranychoidea; Tetranychidae; Tetranychus
Borowiec2015_Total1080_Ixodes_scapularis	 Metazoa; Eumetazoa; Bilateria; Protostomia; Ecdysozoa; Panarthropoda; Arthropoda; Chelicerata; Arachnida; Acari; Parasitiformes; Ixodida; Ixodoidea; Ixodidae; Ixodinae; Ixodes
Borowiec2015_Total1080_Acyrthosiphon_pisum	 Metazoa; Eumetazoa; Bilateria; Protostomia; Ecdysozoa; Panarthropoda; Arthropoda; Mandibulata; Pancrustacea; Hexapoda; Insecta; Dicondylia; Pterygota; Neoptera; Paraneoptera; Hemiptera; Sternorrhyncha; Aphidomorpha; Aphidoidea; Aphididae; Aphidinae; Macrosiphini; Acyrthosiphon
Borowiec2015_Total1080_Lottia_gigantea	 Metazoa; Eumetazoa; Bilateria; Protostomia; Lophotrochozoa; Mollusca; Gastropoda; Patellogastropoda; Lottioidea; Lottiidae; Lottia
Borowiec2015_Total1080_Rhodnius_prolixus	 Metazoa; Eumetazoa; Bilateria; Protostomia; Ecdysozoa; Panarthropoda; Arthropoda; Mandibulata; Pancrustacea; Hexapoda; Insecta; Dicondylia; Pterygota; Neoptera; Paraneoptera; Hemiptera; Prosorrhyncha; Heteroptera; Euheteroptera; Neoheteroptera; Panheteroptera; Cimicomorpha; Reduvioidea; Reduviidae; Triatominae; Rhodnius
Borowiec2015_Total1080_Drosophila_melanogaster	 Metazoa; Eumetazoa; Bilateria; Protostomia; Ecdysozoa; Panarthropoda; Arthropoda; Mandibulata; Pancrustacea; Hexapoda; Insecta; Dicondylia; Pterygota; Neoptera; Holometabola; Diptera; Brachycera; Muscomorpha; Eremoneura; Cyclorrhapha; Schizophora; Acalyptratae; Ephydroidea; Drosophilidae; Drosophilinae; Drosophilini; Drosophila; Sophophora; melanogaster group; melanogaster subgroup
Borowiec2015_Total1080_Tribolium_castaneum	 Metazoa; Eumetazoa; Bilateria; Protostomia; Ecdysozoa; Panarthropoda; Arthropoda; Mandibulata; Pancrustacea; Hexapoda; Insecta; Dicondylia; Pterygota; Neoptera; Holometabola; Coleoptera; Polyphaga; Cucujiformia; Tenebrionoidea; Tenebrionidae; Tenebrionidae incertae sedis; Tribolium
Borowiec2015_Total1080_Apis_mellifera	 Metazoa; Eumetazoa; Bilateria; Protostomia; Ecdysozoa; Panarthropoda; Arthropoda; Mandibulata; Pancrustacea; Hexapoda; Insecta; Dicondylia; Pterygota; Neoptera; Holometabola; Hymenoptera; Apocrita; Aculeata; Apoidea; Apidae; Apinae; Apini; Apis
Borowiec2015_Total1080_Bombus_terrestris	 Metazoa; Eumetazoa; Bilateria; Protostomia; Ecdysozoa; Panarthropoda; Arthropoda; Mandibulata; Pancrustacea; Hexapoda; Insecta; Dicondylia; Pterygota; Neoptera; Holometabola; Hymenoptera; Apocrita; Aculeata; Apoidea; Apidae; Bombinae; Bombini; Bombus; Bombus
Borowiec2015_Total1080_Capitella_teleta	 Metazoa; Eumetazoa; Bilateria; Protostomia; Lophotrochozoa; Annelida; Polychaeta; Scolecida; Capitellida; Capitellidae; Capitella
Borowiec2015_Total1080_Strigamia_maritima	 Metazoa; Eumetazoa; Bilateria; Protostomia; Ecdysozoa; Panarthropoda; Arthropoda; Mandibulata; Myriapoda; Chilopoda; Pleurostigmophora; Epimorpha; Geophilomorpha; Linotaeniidae; Strigamia
Borowiec2015_Total1080_Brugia_malayi	 Metazoa; Eumetazoa; Bilateria; Protostomia; Ecdysozoa; Nematoda; Chromadorea; Rhabditida; Spirurina; Spiruromorpha; Filarioidea; Onchocercidae; Brugia
Borowiec2015_Total1080_Caenorhabditis_elegans	 Metazoa; Eumetazoa; Bilateria; Protostomia; Ecdysozoa; Nematoda; Chromadorea; Rhabditida; Rhabditina; Rhabditomorpha; Rhabditoidea; Rhabditidae; Peloderinae; Caenorhabditis
Borowiec2015_Total1080_Daphnia_magna	 Metazoa; Eumetazoa; Bilateria; Protostomia; Ecdysozoa; Panarthropoda; Arthropoda; Mandibulata; Pancrustacea; Crustacea; Branchiopoda; Phyllopoda; Diplostraca; Cladocera; Anomopoda; Daphniidae; Daphnia
Borowiec2015_Total1080_Hydra_magnipapillata	 Metazoa; Eumetazoa; Cnidaria; Hydrozoa; Hydroidolina; Anthoathecata; Aplanulata; Hydridae; Hydra
Borowiec2015_Total1080_Xenopus_tropicalis	 Metazoa; Eumetazoa; Bilateria; Deuterostomia; Chordata; Craniata; Vertebrata; Gnathostomata; Teleostomi; Euteleostomi; Sarcopterygii; Dipnotetrapodomorpha; Tetrapoda; Amphibia; Batrachia; Anura; Pipoidea; Pipidae; Xenopodinae; Xenopus; Silurana
Borowiec2015_Total1080_Acropora_digitifera	 Metazoa; Eumetazoa; Cnidaria; Anthozoa; Hexacorallia; Scleractinia; Astrocoeniina; Acroporidae; Acropora
Borowiec2015_Total1080_Pinctada_fucata	 Metazoa; Eumetazoa; Bilateria; Protostomia; Lophotrochozoa; Mollusca; Bivalvia; Pteriomorphia; Pterioida; Pterioidea; Pteriidae; Pinctada
Borowiec2015_Total1080_Saccoglossus_kowalevskii	 Metazoa; Eumetazoa; Bilateria; Deuterostomia; Hemichordata; Enteropneusta; Harrimaniidae; Saccoglossus
Borowiec2015_Total1080_Oikopleura_dioica	 Metazoa; Eumetazoa; Bilateria; Deuterostomia; Chordata; Tunicata; Appendicularia; Oikopleuridae; Oikopleura
Chang2015_Acanthoeca_sp	 Choanoflagellida; Acanthoecida; Acanthoecidae
Chang2015_Acropora_cervicornis	 Metazoa; Eumetazoa; Cnidaria; Anthozoa; Hexacorallia; Scleractinia; Astrocoeniina; Acroporidae; Acropora
Chang2015_Aiptasia_pallida	 Metazoa; Eumetazoa; Cnidaria; Anthozoa; Hexacorallia; Actiniaria; Aiptasiidae; Exaiptasia
Chang2015_Amoebidium_parasiticum	 Opisthokonta incertae sedis; Ichthyosporea; Ichthyophonida; Amoebidiaceae; Amoebidium
Chang2015_Amphimedon_queenslandica	 Metazoa; Porifera; Demospongiae; Heteroscleromorpha; Haplosclerida; Niphatidae; Amphimedon
Chang2015_Aphrocallistes_vastus	 Metazoa; Porifera; Hexactinellida; Hexasterophora; Hexactinosida; Sceptrulophora; Aphrocallistidae; Aphrocallistes
Chang2015_Aurelia_aurita	 Metazoa; Eumetazoa; Cnidaria; Scyphozoa; Semaeostomeae; Ulmaridae; Aurelia
Chang2015_Beroe_abyssicola	 Metazoa; Eumetazoa; Ctenophora; Nuda; Beroida; Beroidae; Beroe
Chang2015_Bolocera_tuediae	 Metazoa; Eumetazoa; Cnidaria; Anthozoa; Hexacorallia; Actiniaria; Actiniidae; Bolocera
Chang2015_Botryllus_schlosseri	 Metazoa; Eumetazoa; Bilateria; Deuterostomia; Chordata; Tunicata; Ascidiacea; Stolidobranchia; Styelidae; Botryllus
Chang2015_Branchiostoma_floridae	 Metazoa; Eumetazoa; Bilateria; Deuterostomia; Chordata; Cephalochordata; Branchiostomidae; Branchiostoma
Chang2015_Buddenbrockia_plumatellae	 Metazoa; Eumetazoa; Cnidaria; Myxozoa; Malacosporea; Malacovalvulida; Saccosporidae; Buddenbrockia
Chang2015_Capitella_teleta	 Metazoa; Eumetazoa; Bilateria; Protostomia; Lophotrochozoa; Annelida; Polychaeta; Scolecida; Capitellida; Capitellidae; Capitella
Chang2015_Capsaspora_owczarzaki	 Opisthokonta incertae sedis; Ichthyosporea; Capsaspora
Chang2015_Chondrilla_nucula	 Metazoa; Porifera; Demospongiae; Verongimorpha; Chondrillida; Chondrillidae; Chondrilla
Chang2015_Ciona_intestinalis	 Metazoa; Eumetazoa; Bilateria; Deuterostomia; Chordata; Tunicata; Ascidiacea; Enterogona; Phlebobranchia; Cionidae; Ciona
Chang2015_Clytia_hemisphaerica	 Metazoa; Eumetazoa; Cnidaria; Hydrozoa; Hydroidolina; Leptothecata; Campanulariidae; Clytia
Chang2015_Corticium_candelabrum	 Metazoa; Porifera; Homoscleromorpha; Homosclerophorida; Plakinidae; Corticium
Chang2015_Craspedacusta_sowerbii	 Metazoa; Eumetazoa; Cnidaria; Hydrozoa; Trachylinae; Limnomedusae; Olindiidae; Craspedacusta
Chang2015_Crassostrea_gigas	 Metazoa; Eumetazoa; Bilateria; Protostomia; Lophotrochozoa; Mollusca; Bivalvia; Pteriomorphia; Ostreoida; Ostreoidea; Ostreidae; Crassostrea
Chang2015_Cyanea_capillata	 Metazoa; Eumetazoa; Cnidaria; Scyphozoa; Semaeostomeae; Cyaneidae; Cyanea
Chang2015_Daphnia_pulex	 Metazoa; Eumetazoa; Bilateria; Protostomia; Ecdysozoa; Panarthropoda; Arthropoda; Mandibulata; Pancrustacea; Crustacea; Branchiopoda; Phyllopoda; Diplostraca; Cladocera; Anomopoda; Daphniidae; Daphnia
Chang2015_Ectopleura_larynx	 Metazoa; Eumetazoa; Cnidaria; Hydrozoa; Hydroidolina; Anthoathecata; Aplanulata; Tubulariidae; Ectopleura
Chang2015_Edwardsiella_lineata	 Metazoa; Eumetazoa; Cnidaria; Anthozoa; Hexacorallia; Actiniaria; Edwardsiidae; Edwardsiella
Chang2015_Enteromyxum_leei	 Metazoa; Eumetazoa; Cnidaria; Myxozoa; Myxosporea; Bivalvulida; Variisporina; Myxidiidae; Enteromyxum
Chang2015_Ephydatia_muelleri	 Metazoa; Porifera; Demospongiae; Heteroscleromorpha; Spongillida; Spongillidae; Ephydatia
Chang2015_Eunicella_cavolinii	 Metazoa; Eumetazoa; Cnidaria; Anthozoa; Octocorallia; Alcyonacea; Holaxonia; Gorgoniidae; Eunicella
Chang2015_Euplectella_aspergillum	 Metazoa; Porifera; Hexactinellida; Hexasterophora; Lyssacinosida; Euplectellidae; Euplectella
Chang2015_Euplokamis_dunlapae	 Metazoa; Eumetazoa; Ctenophora; Tentaculata; Cydippida; Euplokamidae; Euplokamis
Chang2015_Gorgonia_ventalina	 Metazoa; Eumetazoa; Cnidaria; Anthozoa; Octocorallia; Alcyonacea; Holaxonia; Gorgoniidae; Gorgonia
Chang2015_Helobdella_robusta	 Metazoa; Eumetazoa; Bilateria; Protostomia; Lophotrochozoa; Annelida; Clitellata; Hirudinea; Hirudinida; Glossiphoniiformes; Glossiphoniidae; Helobdella
Chang2015_Homo_sapiens	 Metazoa; Eumetazoa; Bilateria; Deuterostomia; Chordata; Craniata; Vertebrata; Gnathostomata; Teleostomi; Euteleostomi; Sarcopterygii; Dipnotetrapodomorpha; Tetrapoda; Amniota; Mammalia; Theria; Eutheria; Boreoeutheria; Euarchontoglires; Primates; Haplorrhini; Simiiformes; Catarrhini; Hominoidea; Hominidae; Homininae; Homo
Chang2015_Hormathia_digitata	 Metazoa; Eumetazoa; Cnidaria; Anthozoa; Hexacorallia; Actiniaria; Nynantheae; Hormathiidae; Hormathia
Chang2015_Hydra_vulgaris_01	 Metazoa; Eumetazoa; Cnidaria; Hydrozoa; Hydroidolina; Anthoathecata; Aplanulata; Hydridae; Hydra
Chang2015_Hydractinia_polyclina	 Metazoa; Eumetazoa; Cnidaria; Hydrozoa; Hydroidolina; Anthoathecata; Filifera; Hydractiniidae; Hydractinia
Chang2015_Ilyanassa_obsoleta	 Metazoa; Eumetazoa; Bilateria; Protostomia; Lophotrochozoa; Mollusca; Gastropoda; Caenogastropoda; Neogastropoda; Buccinoidea; Nassariidae; Nassariinae; Tritia
Chang2015_Ixodes_scapularis	 Metazoa; Eumetazoa; Bilateria; Protostomia; Ecdysozoa; Panarthropoda; Arthropoda; Chelicerata; Arachnida; Acari; Parasitiformes; Ixodida; Ixodoidea; Ixodidae; Ixodinae; Ixodes
Chang2015_Kudoa_iwatai	 Metazoa; Eumetazoa; Cnidaria; Myxozoa; Myxosporea; Multivalvulida; Kudoidae; Kudoa
Chang2015_Latimeria_menadoensis	 Metazoa; Eumetazoa; Bilateria; Deuterostomia; Chordata; Craniata; Vertebrata; Gnathostomata; Teleostomi; Euteleostomi; Sarcopterygii; Coelacanthimorpha; Coelacanthiformes; Coelacanthidae; Latimeria
Chang2015_Leucetta_chagosensis	 Metazoa; Porifera; Calcarea; Calcinea; Clathrinida; Leucettidae; Leucetta
Chang2015_Ministeria_vibrans	 Opisthokonta incertae sedis; Ministeria
Chang2015_Mnemiopsis_leidyi	 Metazoa; Eumetazoa; Ctenophora; Tentaculata; Lobata; Bolinopsidae; Mnemiopsis
Chang2015_Monosiga_brevicollis	 Choanoflagellida; Craspedida; Salpingoecidae; Monosiga
Chang2015_Monosiga_ovata	 Choanoflagellida; Craspedida; Salpingoecidae; Monosiga
Chang2015_Orbicella_faveolata	 Metazoa; Eumetazoa; Cnidaria; Anthozoa; Hexacorallia; Scleractinia; Faviina; Merulinidae; Orbicella
Chang2015_Myxobolus_cerebralis	 Metazoa; Eumetazoa; Cnidaria; Myxozoa; Myxosporea; Bivalvulida; Platysporina; Myxobolidae; Myxobolus
Chang2015_Nanomia_bijuga	 Metazoa; Eumetazoa; Cnidaria; Hydrozoa; Hydroidolina; Siphonophorae; Physonectae; Agalmatidae; Nanomia
Chang2015_Nasonia_vitripennis	 Metazoa; Eumetazoa; Bilateria; Protostomia; Ecdysozoa; Panarthropoda; Arthropoda; Mandibulata; Pancrustacea; Hexapoda; Insecta; Dicondylia; Pterygota; Neoptera; Holometabola; Hymenoptera; Apocrita; Parasitoida; Chalcidoidea; Pteromalidae; Pteromalinae; Nasonia
Chang2015_Nematostella_vectensis	 Metazoa; Eumetazoa; Cnidaria; Anthozoa; Hexacorallia; Actiniaria; Edwardsiidae; Nematostella
Chang2015_Octopus_vulgaris	 Metazoa; Eumetazoa; Bilateria; Protostomia; Lophotrochozoa; Mollusca; Cephalopoda; Coleoidea; Neocoleoidea; Octopodiformes; Octopoda; Incirrata; Octopodidae; Octopus
Chang2015_Oscarella_carmela	 Metazoa; Porifera; Homoscleromorpha; Homosclerophorida; Plakinidae; Oscarella
Chang2015_Oscarella_sp_SN-2011	 Metazoa; Porifera; Homoscleromorpha; Homosclerophorida; Plakinidae; Oscarella
Chang2015_Patiria_miniata	 Metazoa; Eumetazoa; Bilateria; Deuterostomia; Echinodermata; Eleutherozoa; Asterozoa; Asteroidea; Valvatacea; Valvatida; Asterinidae; Patiria
Chang2015_Pediculus_humanus	 Metazoa; Eumetazoa; Bilateria; Protostomia; Ecdysozoa; Panarthropoda; Arthropoda; Mandibulata; Pancrustacea; Hexapoda; Insecta; Dicondylia; Pterygota; Neoptera; Paraneoptera; Psocodea; Phthiraptera; Anoplura; Pediculidae; Pediculus
Chang2015_Petromyzon_marinus	 Metazoa; Eumetazoa; Bilateria; Deuterostomia; Chordata; Craniata; Vertebrata; Cyclostomata; Hyperoartia; Petromyzontiformes; Petromyzontidae; Petromyzon
Chang2015_Petrosia_ficiformis	 Metazoa; Porifera; Demospongiae; Heteroscleromorpha; Haplosclerida; Petrosiidae; Petrosia
Chang2015_Pleurobrachia_pileus	 Metazoa; Eumetazoa; Ctenophora; Tentaculata; Cydippida; Pleurobrachiidae; Pleurobrachia
Chang2015_Pocillopora_damicornis	 Metazoa; Eumetazoa; Cnidaria; Anthozoa; Hexacorallia; Scleractinia; Astrocoeniina; Pocilloporidae; Pocillopora
Chang2015_Polypodium_hydriforme	 Metazoa; Eumetazoa; Cnidaria; Polypodiozoa; Polypodiidea; Polypodiidae; Polypodium
Chang2015_Porites_australiensis	 Metazoa; Eumetazoa; Cnidaria; Anthozoa; Hexacorallia; Scleractinia; Fungiina; Poritidae; Porites
Chang2015_Saccoglossus_kowalevskii	 Metazoa; Eumetazoa; Bilateria; Deuterostomia; Hemichordata; Enteropneusta; Harrimaniidae; Saccoglossus
Chang2015_Salpingoeca_sp	 Choanoflagellida; Craspedida; Salpingoecidae
Chang2015_Sarcotragus_fasciculatus	 Metazoa; Porifera; Demospongiae; Keratosa; Dictyoceratida; Irciniidae; Sarcotragus
Chang2015_Sphaeroforma_arctica	 Opisthokonta incertae sedis; Ichthyosporea; Ichthyophonida; Sphaeroforma
Chang2015_Sphaeromyxa_zaharoni	 Metazoa; Eumetazoa; Cnidaria; Myxozoa; Myxosporea; Bivalvulida; Sphaeromyxina; Sphaeromyxidae; Sphaeromyxa
Chang2015_Stephanoeca_diplocostata	 Choanoflagellida; Acanthoecida; Stephanoecidae; Stephanoeca
Chang2015_Stomolophus_meleagris	 Metazoa; Eumetazoa; Cnidaria; Scyphozoa; Rhizostomeae; Rhizostomatidae; Stomolophus
Chang2015_Strigamia_maritima	 Metazoa; Eumetazoa; Bilateria; Protostomia; Ecdysozoa; Panarthropoda; Arthropoda; Mandibulata; Myriapoda; Chilopoda; Pleurostigmophora; Epimorpha; Geophilomorpha; Linotaeniidae; Strigamia
Chang2015_Strongylocentrotus_purpuratus	 Metazoa; Eumetazoa; Bilateria; Deuterostomia; Echinodermata; Eleutherozoa; Echinozoa; Echinoidea; Euechinoidea; Echinacea; Echinoida; Strongylocentrotidae; Strongylocentrotus
Chang2015_Sycon_ciliatum	 Metazoa; Porifera; Calcarea; Calcaronea; Leucosolenida; Sycettidae; Sycon
Chang2015_Sycon_coactum	 Metazoa; Porifera; Calcarea; Calcaronea; Leucosolenida; Sycettidae; Sycon
Chang2015_Tetracapsuloides_bryosalmonae	 Metazoa; Eumetazoa; Cnidaria; Myxozoa; Malacosporea; Malacovalvulida; Saccosporidae; Tetracapsuloides
Chang2015_Thelohanellus_kitauei	 Metazoa; Eumetazoa; Cnidaria; Myxozoa; Myxosporea; Bivalvulida; Platysporina; Myxobolidae; Thelohanellus
Chang2015_Trichoplax_adhaerens	 Metazoa; Placozoa; Trichoplacidae; Trichoplax
Chang2015_Tripedalia_cystophora	 Metazoa; Eumetazoa; Cnidaria; Cubozoa; Carybdeida; Tripedaliidae; Tripedalia
Chang2015_Urticina_eques	 Metazoa; Eumetazoa; Cnidaria; Anthozoa; Hexacorallia; Actiniaria; Actiniidae; Urticina
Chang2015_Vallicula_multiformis	 Metazoa; Eumetazoa; Ctenophora; Tentaculata; Platyctenida; Coeloplanidae; Vallicula
Dunn2008_Acanthoscurria_gomesiana	 Metazoa; Eumetazoa; Bilateria; Protostomia; Ecdysozoa; Panarthropoda; Arthropoda; Chelicerata; Arachnida; Araneae; Mygalomorphae; Theraphosidae; Acanthoscurria
Dunn2008_Acropora_millepora	 Metazoa; Eumetazoa; Cnidaria; Anthozoa; Hexacorallia; Scleractinia; Astrocoeniina; Acroporidae; Acropora
Dunn2008_Amoebidium_parasiticum	 Opisthokonta incertae sedis; Ichthyosporea; Ichthyophonida; Amoebidiaceae; Amoebidium
Dunn2008_Anoplodactylus_eroticus	 Metazoa; Eumetazoa; Bilateria; Protostomia; Ecdysozoa; Panarthropoda; Arthropoda; Chelicerata; Pycnogonida; Pantopoda; Phoxichilidiidae; Anoplodactylus
Dunn2008_Aplysia_californica	 Metazoa; Eumetazoa; Bilateria; Protostomia; Lophotrochozoa; Mollusca; Gastropoda; Heterobranchia; Euthyneura; Euopisthobranchia; Aplysiida; Aplysioidea; Aplysiidae; Aplysia
Dunn2008_Argopecten_irradians	 Metazoa; Eumetazoa; Bilateria; Protostomia; Lophotrochozoa; Mollusca; Bivalvia; Pteriomorphia; Pectinoida; Pectinoidea; Pectinidae; Argopecten
Dunn2008_Asterina_pectinifera	 Metazoa; Eumetazoa; Bilateria; Deuterostomia; Echinodermata; Eleutherozoa; Asterozoa; Asteroidea; Valvatacea; Valvatida; Asterinidae; Patiria
Dunn2008_Biomphalaria_glabrata	 Metazoa; Eumetazoa; Bilateria; Protostomia; Lophotrochozoa; Mollusca; Gastropoda; Heterobranchia; Euthyneura; Panpulmonata; Hygrophila; Lymnaeoidea; Planorbidae; Biomphalaria
Dunn2008_Boophilus_microplus	 Metazoa; Eumetazoa; Bilateria; Protostomia; Ecdysozoa; Panarthropoda; Arthropoda; Chelicerata; Arachnida; Acari; Parasitiformes; Ixodida; Ixodoidea; Ixodidae; Rhipicephalinae; Rhipicephalus; Boophilus
Dunn2008_Branchiostoma_floridae	 Metazoa; Eumetazoa; Bilateria; Deuterostomia; Chordata; Cephalochordata; Branchiostomidae; Branchiostoma
Dunn2008_Capitella_teleta	 Metazoa; Eumetazoa; Bilateria; Protostomia; Lophotrochozoa; Annelida; Polychaeta; Scolecida; Capitellida; Capitellidae; Capitella
Dunn2008_Capsaspora_owczarzaki	 Opisthokonta incertae sedis; Ichthyosporea; Capsaspora
Dunn2008_Carcinoscorpius_rotundicauda	 Metazoa; Eumetazoa; Bilateria; Protostomia; Ecdysozoa; Panarthropoda; Arthropoda; Chelicerata; Merostomata; Xiphosura; Limulidae; Carcinoscorpius
Dunn2008_Carcinus_maenas	 Metazoa; Eumetazoa; Bilateria; Protostomia; Ecdysozoa; Panarthropoda; Arthropoda; Mandibulata; Pancrustacea; Crustacea; Multicrustacea; Malacostraca; Eumalacostraca; Eucarida; Decapoda; Pleocyemata; Brachyura; Eubrachyura; Heterotremata; Portunoidea; Carcinidae; Carcinus
Dunn2008_Carinoma_mutabilis	 Metazoa; Eumetazoa; Bilateria; Protostomia; Lophotrochozoa; Nemertea; Palaeonemertea; Carinomidae; Carinoma
Dunn2008_Cerebratulus_lacteus	 Metazoa; Eumetazoa; Bilateria; Protostomia; Lophotrochozoa; Nemertea; Pilidiophora; Heteronemertea; Cerebratulidae; Cerebratulus
Dunn2008_Chaetoderma_nitidulum	 Metazoa; Eumetazoa; Bilateria; Protostomia; Lophotrochozoa; Mollusca; Aplacophora; Caudofoveata; Chaetodermatida; Chaetodermatidae; Chaetoderma
Dunn2008_Chaetopleura_apiculata	 Metazoa; Eumetazoa; Bilateria; Protostomia; Lophotrochozoa; Mollusca; Polyplacophora; Neoloricata; Chitonida; Chitonina; Chaetopleuridae; Chaetopleura
Dunn2008_Chaetopterus_variopedatus	 Metazoa; Eumetazoa; Bilateria; Protostomia; Lophotrochozoa; Annelida; Polychaeta; Scolecida; Spionida; Chaetopteridae; Chaetopterus
Dunn2008_Ciona_intestinalis	 Metazoa; Eumetazoa; Bilateria; Deuterostomia; Chordata; Tunicata; Ascidiacea; Enterogona; Phlebobranchia; Cionidae; Ciona
Dunn2008_Crassostrea_virginica	 Metazoa; Eumetazoa; Bilateria; Protostomia; Lophotrochozoa; Mollusca; Bivalvia; Pteriomorphia; Ostreoida; Ostreoidea; Ostreidae; Crassostrea
Dunn2008_Cryptococcus_neoformans	 Fungi; Dikarya; Basidiomycota; Agaricomycotina; Tremellomycetes; Tremellales; Cryptococcaceae; Cryptococcus; Cryptococcus neoformans species complex
Dunn2008_Cyanea_capillata	 Metazoa; Eumetazoa; Cnidaria; Scyphozoa; Semaeostomeae; Cyaneidae; Cyanea
Dunn2008_Daphnia_magna	 Metazoa; Eumetazoa; Bilateria; Protostomia; Ecdysozoa; Panarthropoda; Arthropoda; Mandibulata; Pancrustacea; Crustacea; Branchiopoda; Phyllopoda; Diplostraca; Cladocera; Anomopoda; Daphniidae; Daphnia
Dunn2008_Drosophila_melanogaster	 Metazoa; Eumetazoa; Bilateria; Protostomia; Ecdysozoa; Panarthropoda; Arthropoda; Mandibulata; Pancrustacea; Hexapoda; Insecta; Dicondylia; Pterygota; Neoptera; Holometabola; Diptera; Brachycera; Muscomorpha; Eremoneura; Cyclorrhapha; Schizophora; Acalyptratae; Ephydroidea; Drosophilidae; Drosophilinae; Drosophilini; Drosophila; Sophophora; melanogaster group; melanogaster subgroup
Dunn2008_Dugesia_japonica	 Metazoa; Eumetazoa; Bilateria; Platyhelminthes; Rhabditophora; Seriata; Tricladida; Continenticola; Geoplanoidea; Dugesiidae; Dugesia
Dunn2008_Echinococcus_granulosus	 Metazoa; Eumetazoa; Bilateria; Platyhelminthes; Cestoda; Eucestoda; Cyclophyllidea; Taeniidae; Echinococcus; Echinococcus granulosus group
Dunn2008_Echinoderes_horni	 Metazoa; Eumetazoa; Bilateria; Protostomia; Ecdysozoa; Scalidophora; Kinorhyncha; Cyclorhagida; Echinoderidae; Echinoderes
Dunn2008_Euperipatoides_kanangrensis	 Metazoa; Eumetazoa; Bilateria; Protostomia; Ecdysozoa; Panarthropoda; Onychophora; Udeonychophora; Euonychophora; Peripatopsidae; Euperipatoides
Dunn2008_Euprymna_scolopes	 Metazoa; Eumetazoa; Bilateria; Protostomia; Lophotrochozoa; Mollusca; Cephalopoda; Coleoidea; Neocoleoidea; Decapodiformes; Sepiolida; Sepiolidae; Sepiolinae; Euprymna
Dunn2008_Fenneropenaeus_chinensis	 Metazoa; Eumetazoa; Bilateria; Protostomia; Ecdysozoa; Panarthropoda; Arthropoda; Mandibulata; Pancrustacea; Crustacea; Multicrustacea; Malacostraca; Eumalacostraca; Eucarida; Decapoda; Dendrobranchiata; Penaeoidea; Penaeidae; Penaeus
Dunn2008_Gallus_gallus	 Metazoa; Eumetazoa; Bilateria; Deuterostomia; Chordata; Craniata; Vertebrata; Gnathostomata; Teleostomi; Euteleostomi; Sarcopterygii; Dipnotetrapodomorpha; Tetrapoda; Amniota; Sauropsida; Sauria; Archelosauria; Archosauria; Dinosauria; Saurischia; Theropoda; Coelurosauria; Aves; Neognathae; Galloanserae; Galliformes; Phasianidae; Phasianinae; Gallus
Dunn2008_Haementeria_depressa	 Metazoa; Eumetazoa; Bilateria; Protostomia; Lophotrochozoa; Annelida; Clitellata; Hirudinea; Hirudinida; Glossiphoniiformes; Glossiphoniidae; Haementeria
Dunn2008_Homo_sapiens	 Metazoa; Eumetazoa; Bilateria; Deuterostomia; Chordata; Craniata; Vertebrata; Gnathostomata; Teleostomi; Euteleostomi; Sarcopterygii; Dipnotetrapodomorpha; Tetrapoda; Amniota; Mammalia; Theria; Eutheria; Boreoeutheria; Euarchontoglires; Primates; Haplorrhini; Simiiformes; Catarrhini; Hominoidea; Hominidae; Homininae; Homo
Dunn2008_Hydra_vulgaris_01	 Metazoa; Eumetazoa; Cnidaria; Hydrozoa; Hydroidolina; Anthoathecata; Aplanulata; Hydridae; Hydra
Dunn2008_Hydractinia_echinata	 Metazoa; Eumetazoa; Cnidaria; Hydrozoa; Hydroidolina; Anthoathecata; Filifera; Hydractiniidae; Hydractinia
Dunn2008_Hypsibius_dujardini	 Metazoa; Eumetazoa; Bilateria; Protostomia; Ecdysozoa; Panarthropoda; Tardigrada; Eutardigrada; Parachela; Hypsibiidae; Hypsibius
Dunn2008_Lumbricus_rubellus	 Metazoa; Eumetazoa; Bilateria; Protostomia; Lophotrochozoa; Annelida; Clitellata; Oligochaeta; Haplotaxida; Lumbricina; Lumbricidae; Lumbricinae; Lumbricus; Lumbricus rubellus complex
Dunn2008_Macrostomum_lignano	 Metazoa; Eumetazoa; Bilateria; Platyhelminthes; Rhabditophora; Macrostomorpha; Macrostomida; Macrostomidae; Macrostomum
Dunn2008_Mertensiid_sp	 Metazoa; Eumetazoa; Ctenophora; Tentaculata; Cydippida; Mertensiidae; unclassified Mertensiidae
Dunn2008_Mnemiopsis_leidyi	 Metazoa; Eumetazoa; Ctenophora; Tentaculata; Lobata; Bolinopsidae; Mnemiopsis
Dunn2008_Monosiga_ovata	 Choanoflagellida; Craspedida; Salpingoecidae; Monosiga
Dunn2008_Mytilus_galloprovincialis	 Metazoa; Eumetazoa; Bilateria; Protostomia; Lophotrochozoa; Mollusca; Bivalvia; Pteriomorphia; Mytiloida; Mytiloidea; Mytilidae; Mytilinae; Mytilus
Dunn2008_Nematostella_vectensis	 Metazoa; Eumetazoa; Cnidaria; Anthozoa; Hexacorallia; Actiniaria; Edwardsiidae; Nematostella
Dunn2008_Oscarella_carmela	 Metazoa; Porifera; Homoscleromorpha; Homosclerophorida; Plakinidae; Oscarella
Dunn2008_Paraplanocera_oligoglena	 Metazoa; Eumetazoa; Bilateria; Platyhelminthes; Rhabditophora; Polycladida; Acotylea; Stylochoidea; Planoceridae; Paraplanocera
Dunn2008_Phoronis_vancouverensis	 Metazoa; Eumetazoa; Bilateria; Protostomia; Lophotrochozoa; Brachiopoda; Phoroniformea; Phoronis
Dunn2008_Platynereis_dumerilii	 Metazoa; Eumetazoa; Bilateria; Protostomia; Lophotrochozoa; Annelida; Polychaeta; Palpata; Aciculata; Phyllodocida; Nereididae; Platynereis
Dunn2008_Priapulus_caudatus	 Metazoa; Eumetazoa; Bilateria; Protostomia; Ecdysozoa; Scalidophora; Priapulida; Priapulimorpha; Priapulimorphida; Priapulidae; Priapulus
Dunn2008_Ptychodera_flava	 Metazoa; Eumetazoa; Bilateria; Deuterostomia; Hemichordata; Enteropneusta; Ptychoderidae; Ptychodera
Dunn2008_Richtersius_coronifer	 Metazoa; Eumetazoa; Bilateria; Protostomia; Ecdysozoa; Panarthropoda; Tardigrada; Eutardigrada; Parachela; Macrobiotidae; Richtersius
Dunn2008_Saccharomyces_cerevisiae	 Fungi; Dikarya; Ascomycota; saccharomyceta; Saccharomycotina; Saccharomycetes; Saccharomycetales; Saccharomycetaceae; Saccharomyces
Dunn2008_Saccoglossus_kowalevskii	 Metazoa; Eumetazoa; Bilateria; Deuterostomia; Hemichordata; Enteropneusta; Harrimaniidae; Saccoglossus
Dunn2008_Schmidtea_mediterranea	 Metazoa; Eumetazoa; Bilateria; Platyhelminthes; Rhabditophora; Seriata; Tricladida; Continenticola; Geoplanoidea; Dugesiidae; Schmidtea
Dunn2008_Scutigera_coleoptrata	 Metazoa; Eumetazoa; Bilateria; Protostomia; Ecdysozoa; Panarthropoda; Arthropoda; Mandibulata; Myriapoda; Chilopoda; Notostigmophora; Scutigeromorpha; Scutigeridae; Scutigera
Dunn2008_Sphaeroforma_arctica	 Opisthokonta incertae sedis; Ichthyosporea; Ichthyophonida; Sphaeroforma
Dunn2008_Spinochordodes_tellinii	 Metazoa; Eumetazoa; Bilateria; Protostomia; Ecdysozoa; Nematomorpha; Gordioida; Chordodea; Chordodoidea; Chordodidae; Spinochordodes
Dunn2008_Strongylocentrotus_purpuratus	 Metazoa; Eumetazoa; Bilateria; Deuterostomia; Echinodermata; Eleutherozoa; Echinozoa; Echinoidea; Euechinoidea; Echinacea; Echinoida; Strongylocentrotidae; Strongylocentrotus
Dunn2008_Terebratalia_transversa	 Metazoa; Eumetazoa; Bilateria; Protostomia; Lophotrochozoa; Brachiopoda; Rhynchonelliformea; Rhynchonellata; Terebratulida; Terebratellidina; Laqueoidea; Laqueidae; Terebratalia
Dunn2008_Themiste_lageniformis	 Metazoa; Eumetazoa; Bilateria; Protostomia; Lophotrochozoa; Annelida; Polychaeta; Sipuncula; Sipunculidea; Golfingiida; Themistidae; Themiste
Dunn2008_Trichinella_spiralis	 Metazoa; Eumetazoa; Bilateria; Protostomia; Ecdysozoa; Nematoda; Enoplea; Dorylaimia; Trichinellida; Trichinellidae; Trichinella
Dunn2008_Urechis_caupo	 Metazoa; Eumetazoa; Bilateria; Protostomia; Lophotrochozoa; Annelida; Polychaeta; Echiura; Xenopneusta; Urechidae; Urechis
Dunn2008_Xenoturbella_bocki	 Metazoa; Eumetazoa; Bilateria; Xenacoelomorpha; Xenoturbellida; Xenoturbellidae; Xenoturbella
Dunn2008_Xiphinema_index	 Metazoa; Eumetazoa; Bilateria; Protostomia; Ecdysozoa; Nematoda; Enoplea; Dorylaimia; Dorylaimida; Dorylaimina; Longidoroidea; Longidoridae; Xiphinema
Hejnol2009_Acanthoscurria_gomesiana	 Metazoa; Eumetazoa; Bilateria; Protostomia; Ecdysozoa; Panarthropoda; Arthropoda; Chelicerata; Arachnida; Araneae; Mygalomorphae; Theraphosidae; Acanthoscurria
Hejnol2009_Acropora_millepora	 Metazoa; Eumetazoa; Cnidaria; Anthozoa; Hexacorallia; Scleractinia; Astrocoeniina; Acroporidae; Acropora
Hejnol2009_Amoebidium_parasiticum	 Opisthokonta incertae sedis; Ichthyosporea; Ichthyophonida; Amoebidiaceae; Amoebidium
Hejnol2009_Amphimedon_queenslandica	 Metazoa; Porifera; Demospongiae; Heteroscleromorpha; Haplosclerida; Niphatidae; Amphimedon
Hejnol2009_Anoplodactylus_eroticus	 Metazoa; Eumetazoa; Bilateria; Protostomia; Ecdysozoa; Panarthropoda; Arthropoda; Chelicerata; Pycnogonida; Pantopoda; Phoxichilidiidae; Anoplodactylus
Hejnol2009_Aplysia_californica	 Metazoa; Eumetazoa; Bilateria; Protostomia; Lophotrochozoa; Mollusca; Gastropoda; Heterobranchia; Euthyneura; Euopisthobranchia; Aplysiida; Aplysioidea; Aplysiidae; Aplysia
Hejnol2009_Argopecten_irradians	 Metazoa; Eumetazoa; Bilateria; Protostomia; Lophotrochozoa; Mollusca; Bivalvia; Pteriomorphia; Pectinoida; Pectinoidea; Pectinidae; Argopecten
Hejnol2009_Asterina_pectinifera	 Metazoa; Eumetazoa; Bilateria; Deuterostomia; Echinodermata; Eleutherozoa; Asterozoa; Asteroidea; Valvatacea; Valvatida; Asterinidae; Patiria
Hejnol2009_Biomphalaria_glabrata	 Metazoa; Eumetazoa; Bilateria; Protostomia; Lophotrochozoa; Mollusca; Gastropoda; Heterobranchia; Euthyneura; Panpulmonata; Hygrophila; Lymnaeoidea; Planorbidae; Biomphalaria
Hejnol2009_Boophilus_microplus	 Metazoa; Eumetazoa; Bilateria; Protostomia; Ecdysozoa; Panarthropoda; Arthropoda; Chelicerata; Arachnida; Acari; Parasitiformes; Ixodida; Ixodoidea; Ixodidae; Rhipicephalinae; Rhipicephalus; Boophilus
Hejnol2009_Brachionus_plicatilis	 Metazoa; Eumetazoa; Bilateria; Protostomia; Lophotrochozoa; Rotifera; Monogononta; Pseudotrocha; Ploima; Brachionidae; Brachionus
Hejnol2009_Branchiostoma_floridae	 Metazoa; Eumetazoa; Bilateria; Deuterostomia; Chordata; Cephalochordata; Branchiostomidae; Branchiostoma
Hejnol2009_Bugula_neritina	 Metazoa; Eumetazoa; Bilateria; Protostomia; Lophotrochozoa; Bryozoa; Gymnolaemata; Cheilostomatida; Flustrina; Buguloidea; Bugulidae; Bugula
Hejnol2009_Capitella_teleta	 Metazoa; Eumetazoa; Bilateria; Protostomia; Lophotrochozoa; Annelida; Polychaeta; Scolecida; Capitellida; Capitellidae; Capitella
Hejnol2009_Capsaspora_owczarzaki	 Opisthokonta incertae sedis; Ichthyosporea; Capsaspora
Hejnol2009_Carcinoscorpius_rotundicauda	 Metazoa; Eumetazoa; Bilateria; Protostomia; Ecdysozoa; Panarthropoda; Arthropoda; Chelicerata; Merostomata; Xiphosura; Limulidae; Carcinoscorpius
Hejnol2009_Carcinus_maenas	 Metazoa; Eumetazoa; Bilateria; Protostomia; Ecdysozoa; Panarthropoda; Arthropoda; Mandibulata; Pancrustacea; Crustacea; Multicrustacea; Malacostraca; Eumalacostraca; Eucarida; Decapoda; Pleocyemata; Brachyura; Eubrachyura; Heterotremata; Portunoidea; Carcinidae; Carcinus
Hejnol2009_Carinoma_mutabilis	 Metazoa; Eumetazoa; Bilateria; Protostomia; Lophotrochozoa; Nemertea; Palaeonemertea; Carinomidae; Carinoma
Hejnol2009_Cerebratulus_lacteus	 Metazoa; Eumetazoa; Bilateria; Protostomia; Lophotrochozoa; Nemertea; Pilidiophora; Heteronemertea; Cerebratulidae; Cerebratulus
Hejnol2009_Chaetoderma_nitidulum	 Metazoa; Eumetazoa; Bilateria; Protostomia; Lophotrochozoa; Mollusca; Aplacophora; Caudofoveata; Chaetodermatida; Chaetodermatidae; Chaetoderma
Hejnol2009_Chaetopleura_apiculata	 Metazoa; Eumetazoa; Bilateria; Protostomia; Lophotrochozoa; Mollusca; Polyplacophora; Neoloricata; Chitonida; Chitonina; Chaetopleuridae; Chaetopleura
Hejnol2009_Chaetopterus_sp	 Metazoa; Eumetazoa; Bilateria; Protostomia; Lophotrochozoa; Annelida; Polychaeta; Scolecida; Spionida; Chaetopteridae
Hejnol2009_Ciona_intestinalis	 Metazoa; Eumetazoa; Bilateria; Deuterostomia; Chordata; Tunicata; Ascidiacea; Enterogona; Phlebobranchia; Cionidae; Ciona
Hejnol2009_Convoluta_pulchra	 Metazoa; Eumetazoa; Bilateria; Xenacoelomorpha; Acoelomorpha; Acoela; Convolutidae; Convoluta
Hejnol2009_Convolutriloba_longifissura	 Metazoa; Eumetazoa; Bilateria; Xenacoelomorpha; Acoelomorpha; Acoela; Sagittiferidae; Convolutriloba
Hejnol2009_Crassostrea_virginica	 Metazoa; Eumetazoa; Bilateria; Protostomia; Lophotrochozoa; Mollusca; Bivalvia; Pteriomorphia; Ostreoida; Ostreoidea; Ostreidae; Crassostrea
Hejnol2009_Cristatella_mucedo	 Metazoa; Eumetazoa; Bilateria; Protostomia; Lophotrochozoa; Bryozoa; Phylactolaemata; Cristatellidae; Cristatella
Hejnol2009_Cryptococcus_neoformans	 Fungi; Dikarya; Basidiomycota; Agaricomycotina; Tremellomycetes; Tremellales; Cryptococcaceae; Cryptococcus; Cryptococcus neoformans species complex
Hejnol2009_Cyanea_capillata	 Metazoa; Eumetazoa; Cnidaria; Scyphozoa; Semaeostomeae; Cyaneidae; Cyanea
Hejnol2009_Daphnia_pulex	 Metazoa; Eumetazoa; Bilateria; Protostomia; Ecdysozoa; Panarthropoda; Arthropoda; Mandibulata; Pancrustacea; Crustacea; Branchiopoda; Phyllopoda; Diplostraca; Cladocera; Anomopoda; Daphniidae; Daphnia
Hejnol2009_Diplosoma_listerianum	 Metazoa; Eumetazoa; Bilateria; Deuterostomia; Chordata; Tunicata; Ascidiacea; Enterogona; Aplousobranchia; Didemnidae; Diplosoma
Hejnol2009_Drosophila_melanogaster	 Metazoa; Eumetazoa; Bilateria; Protostomia; Ecdysozoa; Panarthropoda; Arthropoda; Mandibulata; Pancrustacea; Hexapoda; Insecta; Dicondylia; Pterygota; Neoptera; Holometabola; Diptera; Brachycera; Muscomorpha; Eremoneura; Cyclorrhapha; Schizophora; Acalyptratae; Ephydroidea; Drosophilidae; Drosophilinae; Drosophilini; Drosophila; Sophophora; melanogaster group; melanogaster subgroup
Hejnol2009_Dugesia_japonica	 Metazoa; Eumetazoa; Bilateria; Platyhelminthes; Rhabditophora; Seriata; Tricladida; Continenticola; Geoplanoidea; Dugesiidae; Dugesia
Hejnol2009_Echinococcus_granulosus	 Metazoa; Eumetazoa; Bilateria; Platyhelminthes; Cestoda; Eucestoda; Cyclophyllidea; Taeniidae; Echinococcus; Echinococcus granulosus group
Hejnol2009_Echinoderes_horni	 Metazoa; Eumetazoa; Bilateria; Protostomia; Ecdysozoa; Scalidophora; Kinorhyncha; Cyclorhagida; Echinoderidae; Echinoderes
Hejnol2009_Epiperipatus_sp	 Metazoa; Eumetazoa; Bilateria; Protostomia; Ecdysozoa; Panarthropoda; Onychophora; Udeonychophora; Euonychophora; Peripatidae
Hejnol2009_Euperipatoides_kanangrensis	 Metazoa; Eumetazoa; Bilateria; Protostomia; Ecdysozoa; Panarthropoda; Onychophora; Udeonychophora; Euonychophora; Peripatopsidae; Euperipatoides
Hejnol2009_Euprymna_scolopes	 Metazoa; Eumetazoa; Bilateria; Protostomia; Lophotrochozoa; Mollusca; Cephalopoda; Coleoidea; Neocoleoidea; Decapodiformes; Sepiolida; Sepiolidae; Sepiolinae; Euprymna
Hejnol2009_Fenneropenaeus_chinensis	 Metazoa; Eumetazoa; Bilateria; Protostomia; Ecdysozoa; Panarthropoda; Arthropoda; Mandibulata; Pancrustacea; Crustacea; Multicrustacea; Malacostraca; Eumalacostraca; Eucarida; Decapoda; Dendrobranchiata; Penaeoidea; Penaeidae; Penaeus
Hejnol2009_Flaccisagitta_enflata	 Metazoa; Eumetazoa; Bilateria; Deuterostomia; Chaetognatha; Sagittoidea; Aphragmophora; Ctenodontina; Sagittidae; Flaccisagitta
Hejnol2009_Gallus_gallus	 Metazoa; Eumetazoa; Bilateria; Deuterostomia; Chordata; Craniata; Vertebrata; Gnathostomata; Teleostomi; Euteleostomi; Sarcopterygii; Dipnotetrapodomorpha; Tetrapoda; Amniota; Sauropsida; Sauria; Archelosauria; Archosauria; Dinosauria; Saurischia; Theropoda; Coelurosauria; Aves; Neognathae; Galloanserae; Galliformes; Phasianidae; Phasianinae; Gallus
Hejnol2009_Gnathostomula_peregrina	 Metazoa; Eumetazoa; Bilateria; Gnathostomulida; Bursovaginoidea; Gnathostomulidae; Gnathostomula
Hejnol2009_Haementeria_depressa	 Metazoa; Eumetazoa; Bilateria; Protostomia; Lophotrochozoa; Annelida; Clitellata; Hirudinea; Hirudinida; Glossiphoniiformes; Glossiphoniidae; Haementeria
Hejnol2009_Halocynthia_roretzi	 Metazoa; Eumetazoa; Bilateria; Deuterostomia; Chordata; Tunicata; Ascidiacea; Stolidobranchia; Pyuridae; Halocynthia
Hejnol2009_Helobdella_robusta	 Metazoa; Eumetazoa; Bilateria; Protostomia; Lophotrochozoa; Annelida; Clitellata; Hirudinea; Hirudinida; Glossiphoniiformes; Glossiphoniidae; Helobdella
Hejnol2009_Homo_sapiens	 Metazoa; Eumetazoa; Bilateria; Deuterostomia; Chordata; Craniata; Vertebrata; Gnathostomata; Teleostomi; Euteleostomi; Sarcopterygii; Dipnotetrapodomorpha; Tetrapoda; Amniota; Mammalia; Theria; Eutheria; Boreoeutheria; Euarchontoglires; Primates; Haplorrhini; Simiiformes; Catarrhini; Hominoidea; Hominidae; Homininae; Homo
Hejnol2009_Hydra_vulgaris_01	 Metazoa; Eumetazoa; Cnidaria; Hydrozoa; Hydroidolina; Anthoathecata; Aplanulata; Hydridae; Hydra
Hejnol2009_Hydractinia_echinata	 Metazoa; Eumetazoa; Cnidaria; Hydrozoa; Hydroidolina; Anthoathecata; Filifera; Hydractiniidae; Hydractinia
Hejnol2009_Hypsibius_dujardini	 Metazoa; Eumetazoa; Bilateria; Protostomia; Ecdysozoa; Panarthropoda; Tardigrada; Eutardigrada; Parachela; Hypsibiidae; Hypsibius
Hejnol2009_Lottia_gigantea	 Metazoa; Eumetazoa; Bilateria; Protostomia; Lophotrochozoa; Mollusca; Gastropoda; Patellogastropoda; Lottioidea; Lottiidae; Lottia
Hejnol2009_Lumbricus_rubellus	 Metazoa; Eumetazoa; Bilateria; Protostomia; Lophotrochozoa; Annelida; Clitellata; Oligochaeta; Haplotaxida; Lumbricina; Lumbricidae; Lumbricinae; Lumbricus; Lumbricus rubellus complex
Hejnol2009_Macrostomum_lignano	 Metazoa; Eumetazoa; Bilateria; Platyhelminthes; Rhabditophora; Macrostomorpha; Macrostomida; Macrostomidae; Macrostomum
Hejnol2009_Meara_stichopi	 Metazoa; Eumetazoa; Bilateria; Xenacoelomorpha; Acoelomorpha; Nemertodermatida; Nemertodermatidae; Meara
Hejnol2009_Mertensiid_sp	 Metazoa; Eumetazoa; Ctenophora; Tentaculata; Cydippida; Mertensiidae; unclassified Mertensiidae
Hejnol2009_Mnemiopsis_leidyi	 Metazoa; Eumetazoa; Ctenophora; Tentaculata; Lobata; Bolinopsidae; Mnemiopsis
Hejnol2009_Monosiga_brevicollis	 Choanoflagellida; Craspedida; Salpingoecidae; Monosiga
Hejnol2009_Monosiga_ovata	 Choanoflagellida; Craspedida; Salpingoecidae; Monosiga
Hejnol2009_Mytilus_galloprovincialis	 Metazoa; Eumetazoa; Bilateria; Protostomia; Lophotrochozoa; Mollusca; Bivalvia; Pteriomorphia; Mytiloida; Mytiloidea; Mytilidae; Mytilinae; Mytilus
Hejnol2009_Myzostoma_seymourcollegiorum	 Metazoa; Eumetazoa; Bilateria; Protostomia; Lophotrochozoa; Annelida; Annelida incertae sedis; Myzostomida; Myzostomatidae; Myzostoma
Hejnol2009_Nematostella_vectensis	 Metazoa; Eumetazoa; Cnidaria; Anthozoa; Hexacorallia; Actiniaria; Edwardsiidae; Nematostella
Hejnol2009_Nemertoderma_westbladi	 Metazoa; Eumetazoa; Bilateria; Xenacoelomorpha; Acoelomorpha; Nemertodermatida; Nemertodermatidae; Nemertoderma
Hejnol2009_Neochildia_fusca	 Metazoa; Eumetazoa; Bilateria; Xenacoelomorpha; Acoelomorpha; Acoela; Anaperidae; Neochildia
Hejnol2009_Onychiurus_arcticus	 Metazoa; Eumetazoa; Bilateria; Protostomia; Ecdysozoa; Panarthropoda; Arthropoda; Mandibulata; Pancrustacea; Hexapoda; Collembola; Poduromorpha; Poduroidea; Onychiuridae; Onychiurinae; Megaphorura
Hejnol2009_Oscarella_carmela	 Metazoa; Porifera; Homoscleromorpha; Homosclerophorida; Plakinidae; Oscarella
Hejnol2009_Paraplanocera_oligoglena	 Metazoa; Eumetazoa; Bilateria; Platyhelminthes; Rhabditophora; Polycladida; Acotylea; Stylochoidea; Planoceridae; Paraplanocera
Hejnol2009_Pedicellina_cernua	 Metazoa; Eumetazoa; Bilateria; Protostomia; Lophotrochozoa; Entoprocta; Pedicellinidae; Pedicellina
Hejnol2009_Pedicellina_sp_JB1	 Metazoa; Eumetazoa; Bilateria; Protostomia; Lophotrochozoa; Entoprocta; Pedicellinidae
Hejnol2009_Philodina_roseola	 Metazoa; Eumetazoa; Bilateria; Protostomia; Lophotrochozoa; Rotifera; Bdelloidea; Philodinida; Philodinidae; Philodina
Hejnol2009_Phoronis_vancouverensis	 Metazoa; Eumetazoa; Bilateria; Protostomia; Lophotrochozoa; Brachiopoda; Phoroniformea; Phoronis
Hejnol2009_Platynereis_dumerilii	 Metazoa; Eumetazoa; Bilateria; Protostomia; Lophotrochozoa; Annelida; Polychaeta; Palpata; Aciculata; Phyllodocida; Nereididae; Platynereis
Hejnol2009_Pleurobrachia_pileus	 Metazoa; Eumetazoa; Ctenophora; Tentaculata; Cydippida; Pleurobrachiidae; Pleurobrachia
Hejnol2009_Priapulus_caudatus	 Metazoa; Eumetazoa; Bilateria; Protostomia; Ecdysozoa; Scalidophora; Priapulida; Priapulimorpha; Priapulimorphida; Priapulidae; Priapulus
Hejnol2009_Ptychodera_flava	 Metazoa; Eumetazoa; Bilateria; Deuterostomia; Hemichordata; Enteropneusta; Ptychoderidae; Ptychodera
Hejnol2009_Richtersius_coronifer	 Metazoa; Eumetazoa; Bilateria; Protostomia; Ecdysozoa; Panarthropoda; Tardigrada; Eutardigrada; Parachela; Macrobiotidae; Richtersius
Hejnol2009_Saccharomyces_cerevisiae	 Fungi; Dikarya; Ascomycota; saccharomyceta; Saccharomycotina; Saccharomycetes; Saccharomycetales; Saccharomycetaceae; Saccharomyces
Hejnol2009_Saccoglossus_kowalevskii	 Metazoa; Eumetazoa; Bilateria; Deuterostomia; Hemichordata; Enteropneusta; Harrimaniidae; Saccoglossus
Hejnol2009_Schmidtea_mediterranea	 Metazoa; Eumetazoa; Bilateria; Platyhelminthes; Rhabditophora; Seriata; Tricladida; Continenticola; Geoplanoidea; Dugesiidae; Schmidtea
Hejnol2009_Scutigera_coleoptrata	 Metazoa; Eumetazoa; Bilateria; Protostomia; Ecdysozoa; Panarthropoda; Arthropoda; Mandibulata; Myriapoda; Chilopoda; Notostigmophora; Scutigeromorpha; Scutigeridae; Scutigera
Hejnol2009_Spadella_cephaloptera	 Metazoa; Eumetazoa; Bilateria; Deuterostomia; Chaetognatha; Sagittoidea; Phragmophora; Spadellidae; Spadella
Hejnol2009_Sphaeroforma_arctica	 Opisthokonta incertae sedis; Ichthyosporea; Ichthyophonida; Sphaeroforma
Hejnol2009_Spinochordodes_tellinii	 Metazoa; Eumetazoa; Bilateria; Protostomia; Ecdysozoa; Nematomorpha; Gordioida; Chordodea; Chordodoidea; Chordodidae; Spinochordodes
Hejnol2009_Strongylocentrotus_purpuratus	 Metazoa; Eumetazoa; Bilateria; Deuterostomia; Echinodermata; Eleutherozoa; Echinozoa; Echinoidea; Euechinoidea; Echinacea; Echinoida; Strongylocentrotidae; Strongylocentrotus
Hejnol2009_Suberites_domuncula	 Metazoa; Porifera; Demospongiae; Heteroscleromorpha; Suberitida; Suberitidae; Suberites
Hejnol2009_Symbion_pandora	 Metazoa; Eumetazoa; Bilateria; Protostomia; Lophotrochozoa; Cycliophora; Symbion
Hejnol2009_Symsagittifera_roscoffensis	 Metazoa; Eumetazoa; Bilateria; Xenacoelomorpha; Acoelomorpha; Acoela; Sagittiferidae; Symsagittifera
Hejnol2009_Taenia_solium	 Metazoa; Eumetazoa; Bilateria; Platyhelminthes; Cestoda; Eucestoda; Cyclophyllidea; Taeniidae; Taenia
Hejnol2009_Terebratalia_transversa	 Metazoa; Eumetazoa; Bilateria; Protostomia; Lophotrochozoa; Brachiopoda; Rhynchonelliformea; Rhynchonellata; Terebratulida; Terebratellidina; Laqueoidea; Laqueidae; Terebratalia
Hejnol2009_Themiste_lageniformis	 Metazoa; Eumetazoa; Bilateria; Protostomia; Lophotrochozoa; Annelida; Polychaeta; Sipuncula; Sipunculidea; Golfingiida; Themistidae; Themiste
Hejnol2009_Trichinella_spiralis	 Metazoa; Eumetazoa; Bilateria; Protostomia; Ecdysozoa; Nematoda; Enoplea; Dorylaimia; Trichinellida; Trichinellidae; Trichinella
Hejnol2009_Trichoplax_adhaerens	 Metazoa; Placozoa; Trichoplacidae; Trichoplax
Hejnol2009_Turbanella_ambronensis	 Metazoa; Eumetazoa; Bilateria; Protostomia; Lophotrochozoa; Gastrotricha; Macrodasyida; Turbanellidae; Turbanella
Hejnol2009_Urechis_caupo	 Metazoa; Eumetazoa; Bilateria; Protostomia; Lophotrochozoa; Annelida; Polychaeta; Echiura; Xenopneusta; Urechidae; Urechis
Hejnol2009_Xenoturbella_bocki	 Metazoa; Eumetazoa; Bilateria; Xenacoelomorpha; Xenoturbellida; Xenoturbellidae; Xenoturbella
Hejnol2009_Xiphinema_index	 Metazoa; Eumetazoa; Bilateria; Protostomia; Ecdysozoa; Nematoda; Enoplea; Dorylaimia; Dorylaimida; Dorylaimina; Longidoroidea; Longidoridae; Xiphinema
Moroz2014_3d_Crassostrea_gigas	 Metazoa; Eumetazoa; Bilateria; Protostomia; Lophotrochozoa; Mollusca; Bivalvia; Pteriomorphia; Ostreoida; Ostreoidea; Ostreidae; Crassostrea
Moroz2014_3d_Bolinopsis_infundibulum	 Metazoa; Eumetazoa; Ctenophora; Tentaculata; Lobata; Bolinopsidae; Bolinopsis
Moroz2014_3d_Ephydatia_muelleri	 Metazoa; Porifera; Demospongiae; Heteroscleromorpha; Spongillida; Spongillidae; Ephydatia
Moroz2014_3d_Podocoryna_carnea	 Metazoa; Eumetazoa; Cnidaria; Hydrozoa; Hydroidolina; Anthoathecata; Filifera; Hydractiniidae; Podocoryna
Moroz2014_3d_Lottia_gigantea	 Metazoa; Eumetazoa; Bilateria; Protostomia; Lophotrochozoa; Mollusca; Gastropoda; Patellogastropoda; Lottioidea; Lottiidae; Lottia
Moroz2014_3d_Capitella_teleta	 Metazoa; Eumetazoa; Bilateria; Protostomia; Lophotrochozoa; Annelida; Polychaeta; Scolecida; Capitellida; Capitellidae; Capitella
Moroz2014_3d_Salpingoeca_rosetta	 Choanoflagellida; Craspedida; Salpingoecidae; Salpingoeca
Moroz2014_3d_Trichoplax_adhaerens	 Metazoa; Placozoa; Trichoplacidae; Trichoplax
Moroz2014_3d_Monosiga_brevicollis	 Choanoflagellida; Craspedida; Salpingoecidae; Monosiga
Moroz2014_3d_Porites_astreoides	 Metazoa; Eumetazoa; Cnidaria; Anthozoa; Hexacorallia; Scleractinia; Fungiina; Poritidae; Porites
Moroz2014_3d_Drosophila_melanogaster	 Metazoa; Eumetazoa; Bilateria; Protostomia; Ecdysozoa; Panarthropoda; Arthropoda; Mandibulata; Pancrustacea; Hexapoda; Insecta; Dicondylia; Pterygota; Neoptera; Holometabola; Diptera; Brachycera; Muscomorpha; Eremoneura; Cyclorrhapha; Schizophora; Acalyptratae; Ephydroidea; Drosophilidae; Drosophilinae; Drosophilini; Drosophila; Sophophora; melanogaster group; melanogaster subgroup
Moroz2014_3d_Pleurobrachia_bachei	 Metazoa; Eumetazoa; Ctenophora; Tentaculata; Cydippida; Pleurobrachiidae; Pleurobrachia
Moroz2014_3d_Beroe_abyssicola	 Metazoa; Eumetazoa; Ctenophora; Nuda; Beroida; Beroidae; Beroe
Moroz2014_3d_Coeloplana_astericola	 Metazoa; Eumetazoa; Ctenophora; Tentaculata; Platyctenida; Coeloplanidae; Coeloplana
Moroz2014_3d_Carteriospongia_foliascens	 Metazoa; Porifera; Demospongiae; Keratosa; Dictyoceratida; Thorectidae; Carteriospongia
Moroz2014_3d_Ixodes_scapularis	 Metazoa; Eumetazoa; Bilateria; Protostomia; Ecdysozoa; Panarthropoda; Arthropoda; Chelicerata; Arachnida; Acari; Parasitiformes; Ixodida; Ixodoidea; Ixodidae; Ixodinae; Ixodes
Moroz2014_3d_Branchiostoma_floridae	 Metazoa; Eumetazoa; Bilateria; Deuterostomia; Chordata; Cephalochordata; Branchiostomidae; Branchiostoma
Moroz2014_3d_Pleurobrachia_pileus	 Metazoa; Eumetazoa; Ctenophora; Tentaculata; Cydippida; Pleurobrachiidae; Pleurobrachia
Moroz2014_3d_Dryodora_glandiformis_	 Metazoa; Eumetazoa; Ctenophora; Tentaculata; Cydippida; Dryodoridae; Dryodora
Moroz2014_3d_Anemonia_viridis	 Metazoa; Eumetazoa; Cnidaria; Anthozoa; Hexacorallia; Actiniaria; Actiniidae; Anemonia
Moroz2014_3d_Euplokamis_dunlapae	 Metazoa; Eumetazoa; Ctenophora; Tentaculata; Cydippida; Euplokamidae; Euplokamis
Moroz2014_3d_Mertensiidae_sp	 Metazoa; Eumetazoa; Ctenophora; Tentaculata; Cydippida; Mertensiidae; unclassified Mertensiidae
Moroz2014_3d_Daphnia_pulex	 Metazoa; Eumetazoa; Bilateria; Protostomia; Ecdysozoa; Panarthropoda; Arthropoda; Mandibulata; Pancrustacea; Crustacea; Branchiopoda; Phyllopoda; Diplostraca; Cladocera; Anomopoda; Daphniidae; Daphnia
Moroz2014_3d_Pleurobrachia_sp	 Metazoa; Eumetazoa; Ctenophora; Tentaculata; Cydippida; Pleurobrachiidae
Moroz2014_3d_Amphimedon_queenslandica	 Metazoa; Porifera; Demospongiae; Heteroscleromorpha; Haplosclerida; Niphatidae; Amphimedon
Moroz2014_3d_Homo_sapiens	 Metazoa; Eumetazoa; Bilateria; Deuterostomia; Chordata; Craniata; Vertebrata; Gnathostomata; Teleostomi; Euteleostomi; Sarcopterygii; Dipnotetrapodomorpha; Tetrapoda; Amniota; Mammalia; Theria; Eutheria; Boreoeutheria; Euarchontoglires; Primates; Haplorrhini; Simiiformes; Catarrhini; Hominoidea; Hominidae; Homininae; Homo
Moroz2014_3d_Strongylocentrotus_purpuratus	 Metazoa; Eumetazoa; Bilateria; Deuterostomia; Echinodermata; Eleutherozoa; Echinozoa; Echinoidea; Euechinoidea; Echinacea; Echinoida; Strongylocentrotidae; Strongylocentrotus
Moroz2014_3d_Hydra_vulgaris	 Metazoa; Eumetazoa; Cnidaria; Hydrozoa; Hydroidolina; Anthoathecata; Aplanulata; Hydridae; Hydra
Moroz2014_3d_Vallicula_sp	 Metazoa; Eumetazoa; Ctenophora; Tentaculata; Platyctenida; Coeloplanidae
Moroz2014_3d_Aplysia_californica	 Metazoa; Eumetazoa; Bilateria; Protostomia; Lophotrochozoa; Mollusca; Gastropoda; Heterobranchia; Euthyneura; Euopisthobranchia; Aplysiida; Aplysioidea; Aplysiidae; Aplysia
Moroz2014_3d_Sycon_coactum	 Metazoa; Porifera; Calcarea; Calcaronea; Leucosolenida; Sycettidae; Sycon
Moroz2014_3d_Hydractinia_echinata	 Metazoa; Eumetazoa; Cnidaria; Hydrozoa; Hydroidolina; Anthoathecata; Filifera; Hydractiniidae; Hydractinia
Moroz2014_3d_Monosiga_ovata	 Choanoflagellida; Craspedida; Salpingoecidae; Monosiga
Moroz2014_3d_Oopsacas_minuta	 Metazoa; Porifera; Hexactinellida; Hexasterophora; Lyssacinosida; Leucopsacidae; Oopsacas
Moroz2014_3d_Gorgonia_ventalina	 Metazoa; Eumetazoa; Cnidaria; Anthozoa; Octocorallia; Alcyonacea; Holaxonia; Gorgoniidae; Gorgonia
Moroz2014_3d_Mnemiopsis_leidyi	 Metazoa; Eumetazoa; Ctenophora; Tentaculata; Lobata; Bolinopsidae; Mnemiopsis
Moroz2014_3d_Ciona_intestinalis	 Metazoa; Eumetazoa; Bilateria; Deuterostomia; Chordata; Tunicata; Ascidiacea; Enterogona; Phlebobranchia; Cionidae; Ciona
Moroz2014_3d_Aphrocallistes_vastus	 Metazoa; Porifera; Hexactinellida; Hexasterophora; Hexactinosida; Sceptrulophora; Aphrocallistidae; Aphrocallistes
Moroz2014_3d_Aiptasia_pallida	 Metazoa; Eumetazoa; Cnidaria; Anthozoa; Hexacorallia; Actiniaria; Aiptasiidae; Exaiptasia
Moroz2014_3d_Oscarella_carmela	 Metazoa; Porifera; Homoscleromorpha; Homosclerophorida; Plakinidae; Oscarella
Moroz2014_3d_Clytia_hemisphaerica	 Metazoa; Eumetazoa; Cnidaria; Hydrozoa; Hydroidolina; Leptothecata; Campanulariidae; Clytia
Moroz2014_3d_Acropora_digitifera	 Metazoa; Eumetazoa; Cnidaria; Anthozoa; Hexacorallia; Scleractinia; Astrocoeniina; Acroporidae; Acropora
Moroz2014_3d_Nematostella_vectensis	 Metazoa; Eumetazoa; Cnidaria; Anthozoa; Hexacorallia; Actiniaria; Edwardsiidae; Nematostella
Moroz2014_3d_Saccoglossus_kowalevskii	 Metazoa; Eumetazoa; Bilateria; Deuterostomia; Hemichordata; Enteropneusta; Harrimaniidae; Saccoglossus
Moroz2014_3d_Leucetta_chagosensis	 Metazoa; Porifera; Calcarea; Calcinea; Clathrinida; Leucettidae; Leucetta
Moroz2014_3d_Heterochone_calyx	 Metazoa; Porifera; Hexactinellida; Hexasterophora; Hexactinosida; Sceptrulophora; Aphrocallistidae; Heterochone
Nosenko2013_nonribo_9187_Acropora_hyacinthus	 Metazoa; Eumetazoa; Cnidaria; Anthozoa; Hexacorallia; Scleractinia; Astrocoeniina; Acroporidae; Acropora
Nosenko2013_nonribo_9187_Acropora_millepora	 Metazoa; Eumetazoa; Cnidaria; Anthozoa; Hexacorallia; Scleractinia; Astrocoeniina; Acroporidae; Acropora
Nosenko2013_nonribo_9187_Acropora_palmata	 Metazoa; Eumetazoa; Cnidaria; Anthozoa; Hexacorallia; Scleractinia; Astrocoeniina; Acroporidae; Acropora
Nosenko2013_nonribo_9187_Allomyces_macrogynus	 Fungi; Fungi incertae sedis; Blastocladiomycota; Blastocladiomycetes; Blastocladiales; Blastocladiaceae; Allomyces
Nosenko2013_nonribo_9187_Amoebidium_parasiticum	 Opisthokonta incertae sedis; Ichthyosporea; Ichthyophonida; Amoebidiaceae; Amoebidium
Nosenko2013_nonribo_9187_Amphimedon_queenslandica	 Metazoa; Porifera; Demospongiae; Heteroscleromorpha; Haplosclerida; Niphatidae; Amphimedon
Nosenko2013_nonribo_9187_Anoplodactylus_eroticus	 Metazoa; Eumetazoa; Bilateria; Protostomia; Ecdysozoa; Panarthropoda; Arthropoda; Chelicerata; Pycnogonida; Pantopoda; Phoxichilidiidae; Anoplodactylus
Nosenko2013_nonribo_9187_Aplysia_californica	 Metazoa; Eumetazoa; Bilateria; Protostomia; Lophotrochozoa; Mollusca; Gastropoda; Heterobranchia; Euthyneura; Euopisthobranchia; Aplysiida; Aplysioidea; Aplysiidae; Aplysia
Nosenko2013_nonribo_9187_Aphrocallistes_vastus	 Metazoa; Porifera; Hexactinellida; Hexasterophora; Hexactinosida; Sceptrulophora; Aphrocallistidae; Aphrocallistes
Nosenko2013_nonribo_9187_Asbestopluma_sp	 Metazoa; Porifera; Demospongiae; Heteroscleromorpha; Poecilosclerida; Cladorhizidae
Nosenko2013_nonribo_9187_Astrosclera_willeyana	 Metazoa; Porifera; Demospongiae; Heteroscleromorpha; Agelasida; Astroscleridae; Astrosclera
Nosenko2013_nonribo_9187_Batrachochytrium_dendrobatidis	 Fungi; Fungi incertae sedis; Chytridiomycota; Chytridiomycetes; Rhizophydiales; Rhizophydiales incertae sedis; Batrachochytrium
Nosenko2013_nonribo_9187_Beroe_sp	 Metazoa; Eumetazoa; Ctenophora; Nuda; Beroida; Beroidae
Nosenko2013_nonribo_9187_Branchiostoma_floridae	 Metazoa; Eumetazoa; Bilateria; Deuterostomia; Chordata; Cephalochordata; Branchiostomidae; Branchiostoma
Nosenko2013_nonribo_9187_Capitella_teleta	 Metazoa; Eumetazoa; Bilateria; Protostomia; Lophotrochozoa; Annelida; Polychaeta; Scolecida; Capitellida; Capitellidae; Capitella
Nosenko2013_nonribo_9187_Capsaspora_owczarzaki	 Opisthokonta incertae sedis; Ichthyosporea; Capsaspora
Nosenko2013_nonribo_9187_Carteriospongia_foliascens	 Metazoa; Porifera; Demospongiae; Keratosa; Dictyoceratida; Thorectidae; Carteriospongia
Nosenko2013_nonribo_9187_Ciona_intestinalis	 Metazoa; Eumetazoa; Bilateria; Deuterostomia; Chordata; Tunicata; Ascidiacea; Enterogona; Phlebobranchia; Cionidae; Ciona
Nosenko2013_nonribo_9187_Clytia_hemisphaerica	 Metazoa; Eumetazoa; Cnidaria; Hydrozoa; Hydroidolina; Leptothecata; Campanulariidae; Clytia
Nosenko2013_nonribo_9187_Corticium	 Fungi; Dikarya; Basidiomycota; Agaricomycotina; Agaricomycetes; Agaricomycetes incertae sedis; Corticiales; Corticiaceae
Nosenko2013_nonribo_9187_Crassostrea_gigas	 Metazoa; Eumetazoa; Bilateria; Protostomia; Lophotrochozoa; Mollusca; Bivalvia; Pteriomorphia; Ostreoida; Ostreoidea; Ostreidae; Crassostrea
Nosenko2013_nonribo_9187_Crateromorpha_meyeri	 Metazoa; Porifera; Hexactinellida; Hexasterophora; Lyssacinosida; Rossellidae; Crateromorpha
Nosenko2013_nonribo_9187_Cyanea_capillata	 Metazoa; Eumetazoa; Cnidaria; Scyphozoa; Semaeostomeae; Cyaneidae; Cyanea
Nosenko2013_nonribo_9187_Danio_rerio	 Metazoa; Eumetazoa; Bilateria; Deuterostomia; Chordata; Craniata; Vertebrata; Gnathostomata; Teleostomi; Euteleostomi; Actinopterygii; Actinopteri; Neopterygii; Teleostei; Osteoglossocephalai; Clupeocephala; Otomorpha; Ostariophysi; Otophysi; Cypriniphysae; Cypriniformes; Cyprinoidea; Cyprinidae; Danio
Nosenko2013_nonribo_9187_Daphnia_pulex	 Metazoa; Eumetazoa; Bilateria; Protostomia; Ecdysozoa; Panarthropoda; Arthropoda; Mandibulata; Pancrustacea; Crustacea; Branchiopoda; Phyllopoda; Diplostraca; Cladocera; Anomopoda; Daphniidae; Daphnia
Nosenko2013_nonribo_9187_Ephydatia_muelleri	 Metazoa; Porifera; Demospongiae; Heteroscleromorpha; Spongillida; Spongillidae; Ephydatia
Nosenko2013_nonribo_9187_Euprymna_scolopes	 Metazoa; Eumetazoa; Bilateria; Protostomia; Lophotrochozoa; Mollusca; Cephalopoda; Coleoidea; Neocoleoidea; Decapodiformes; Sepiolida; Sepiolidae; Sepiolinae; Euprymna
Nosenko2013_nonribo_9187_Helobdella_robusta	 Metazoa; Eumetazoa; Bilateria; Protostomia; Lophotrochozoa; Annelida; Clitellata; Hirudinea; Hirudinida; Glossiphoniiformes; Glossiphoniidae; Helobdella
Nosenko2013_nonribo_9187_Heterochone_calyx	 Metazoa; Porifera; Hexactinellida; Hexasterophora; Hexactinosida; Sceptrulophora; Aphrocallistidae; Heterochone
Nosenko2013_nonribo_9187_Hydra_magnipapillata	 Metazoa; Eumetazoa; Cnidaria; Hydrozoa; Hydroidolina; Anthoathecata; Aplanulata; Hydridae; Hydra
Nosenko2013_nonribo_9187_Hydra_vulgaris	 Metazoa; Eumetazoa; Cnidaria; Hydrozoa; Hydroidolina; Anthoathecata; Aplanulata; Hydridae; Hydra
Nosenko2013_nonribo_9187_Hydractinia_echinata	 Metazoa; Eumetazoa; Cnidaria; Hydrozoa; Hydroidolina; Anthoathecata; Filifera; Hydractiniidae; Hydractinia
Nosenko2013_nonribo_9187_Ixodes_scapularis	 Metazoa; Eumetazoa; Bilateria; Protostomia; Ecdysozoa; Panarthropoda; Arthropoda; Chelicerata; Arachnida; Acari; Parasitiformes; Ixodida; Ixodoidea; Ixodidae; Ixodinae; Ixodes
Nosenko2013_nonribo_9187_Leucetta_chagosensis	 Metazoa; Porifera; Calcarea; Calcinea; Clathrinida; Leucettidae; Leucetta
Nosenko2013_nonribo_9187_Leucosolenia_sp	 Metazoa; Porifera; Calcarea; Calcaronea; Leucosolenida; Leucosoleniidae
Nosenko2013_nonribo_9187_Lubomirskia_baicalensis	 Metazoa; Porifera; Demospongiae; Heteroscleromorpha; Spongillida; Lubomirskiidae; Lubomirskia
Nosenko2013_nonribo_9187_Mertensiid_sp	 Metazoa; Eumetazoa; Ctenophora; Tentaculata; Cydippida; Mertensiidae; unclassified Mertensiidae
Nosenko2013_nonribo_9187_Metridium_senile	 Metazoa; Eumetazoa; Cnidaria; Anthozoa; Hexacorallia; Actiniaria; Nynantheae; Metridiidae; Metridium
Nosenko2013_nonribo_9187_Mnemiopsis_leidyi	 Metazoa; Eumetazoa; Ctenophora; Tentaculata; Lobata; Bolinopsidae; Mnemiopsis
Nosenko2013_nonribo_9187_Molgula_tectiformis	 Metazoa; Eumetazoa; Bilateria; Deuterostomia; Chordata; Tunicata; Ascidiacea; Stolidobranchia; Molgulidae; Molgula
Nosenko2013_nonribo_9187_Monosiga_brevicollis	 Choanoflagellida; Craspedida; Salpingoecidae; Monosiga
Nosenko2013_nonribo_9187_Monosiga_ovata	 Choanoflagellida; Craspedida; Salpingoecidae; Monosiga
Nosenko2013_nonribo_9187_Montastraea_faveolata	 Metazoa; Eumetazoa; Cnidaria; Anthozoa; Hexacorallia; Scleractinia; Faviina; Merulinidae; Orbicella
Nosenko2013_nonribo_9187_Nasonia_vitripennis	 Metazoa; Eumetazoa; Bilateria; Protostomia; Ecdysozoa; Panarthropoda; Arthropoda; Mandibulata; Pancrustacea; Hexapoda; Insecta; Dicondylia; Pterygota; Neoptera; Holometabola; Hymenoptera; Apocrita; Parasitoida; Chalcidoidea; Pteromalidae; Pteromalinae; Nasonia
Nosenko2013_nonribo_9187_Nematostella_vectensis	 Metazoa; Eumetazoa; Cnidaria; Anthozoa; Hexacorallia; Actiniaria; Edwardsiidae; Nematostella
Nosenko2013_nonribo_9187_Oopsacas_minuta	 Metazoa; Porifera; Hexactinellida; Hexasterophora; Lyssacinosida; Leucopsacidae; Oopsacas
Nosenko2013_nonribo_9187_Oscarella_carmela	 Metazoa; Porifera; Homoscleromorpha; Homosclerophorida; Plakinidae; Oscarella
Nosenko2013_nonribo_9187_Oscarella_lobularis	 Metazoa; Porifera; Homoscleromorpha; Homosclerophorida; Plakinidae; Oscarella
Nosenko2013_nonribo_9187_Oscarella_sp	 Metazoa; Porifera; Homoscleromorpha; Homosclerophorida; Plakinidae
Nosenko2013_nonribo_9187_Pachydictyum_globosum	 Metazoa; Porifera; Demospongiae; Heteroscleromorpha; Spongillida; Lubomirskiidae; Pachydictyum
Nosenko2013_nonribo_9187_Pedicellina_cernua	 Metazoa; Eumetazoa; Bilateria; Protostomia; Lophotrochozoa; Entoprocta; Pedicellinidae; Pedicellina
Nosenko2013_nonribo_9187_Pediculus_humanus_capitis	 Metazoa; Eumetazoa; Bilateria; Protostomia; Ecdysozoa; Panarthropoda; Arthropoda; Mandibulata; Pancrustacea; Hexapoda; Insecta; Dicondylia; Pterygota; Neoptera; Paraneoptera; Psocodea; Phthiraptera; Anoplura; Pediculidae; Pediculus; Pediculus humanus
Nosenko2013_nonribo_9187_Petromyzon_marinus	 Metazoa; Eumetazoa; Bilateria; Deuterostomia; Chordata; Craniata; Vertebrata; Cyclostomata; Hyperoartia; Petromyzontiformes; Petromyzontidae; Petromyzon
Nosenko2013_nonribo_9187_Phycomyces_blakesleeanus	 Fungi; Fungi incertae sedis; Mucoromycota; Mucoromycotina; Mucoromycetes; Mucorales; Phycomycetaceae; Phycomyces
Nosenko2013_nonribo_9187_Pleurobrachia_pileus	 Metazoa; Eumetazoa; Ctenophora; Tentaculata; Cydippida; Pleurobrachiidae; Pleurobrachia
Nosenko2013_nonribo_9187_Podocoryna_carnea	 Metazoa; Eumetazoa; Cnidaria; Hydrozoa; Hydroidolina; Anthoathecata; Filifera; Hydractiniidae; Podocoryna
Nosenko2013_nonribo_9187_Porites	 Metazoa; Eumetazoa; Cnidaria; Anthozoa; Hexacorallia; Scleractinia; Fungiina; Poritidae
Nosenko2013_nonribo_9187_Proterospongia_sp	 Choanoflagellida; Craspedida; Salpingoecidae
Nosenko2013_nonribo_9187_Saccoglossus_kowalevskii	 Metazoa; Eumetazoa; Bilateria; Deuterostomia; Hemichordata; Enteropneusta; Harrimaniidae; Saccoglossus
Nosenko2013_nonribo_9187_Scutigera_coleoptrata	 Metazoa; Eumetazoa; Bilateria; Protostomia; Ecdysozoa; Panarthropoda; Arthropoda; Mandibulata; Myriapoda; Chilopoda; Notostigmophora; Scutigeromorpha; Scutigeridae; Scutigera
Nosenko2013_nonribo_9187_Spizellomyces_punctatus	 Fungi; Fungi incertae sedis; Chytridiomycota; Chytridiomycetes; Spizellomycetales; Spizellomycetaceae; Spizellomyces
Nosenko2013_nonribo_9187_Sphaeroforma_arctica	 Opisthokonta incertae sedis; Ichthyosporea; Ichthyophonida; Sphaeroforma
Nosenko2013_nonribo_9187_Strongylocentrotus_purpuratus	 Metazoa; Eumetazoa; Bilateria; Deuterostomia; Echinodermata; Eleutherozoa; Echinozoa; Echinoidea; Euechinoidea; Echinacea; Echinoida; Strongylocentrotidae; Strongylocentrotus
Nosenko2013_nonribo_9187_Suberites_domuncula	 Metazoa; Porifera; Demospongiae; Heteroscleromorpha; Suberitida; Suberitidae; Suberites
Nosenko2013_nonribo_9187_Sycon_ciliatum	 Metazoa; Porifera; Calcarea; Calcaronea; Leucosolenida; Sycettidae; Sycon
Nosenko2013_nonribo_9187_Sycon_raphanus	 Metazoa; Porifera; Calcarea; Calcaronea; Leucosolenida; Sycettidae; Sycon
Nosenko2013_nonribo_9187_Tethya_wilhelma	 Metazoa; Porifera; Demospongiae; Heteroscleromorpha; Tethyida; Tethyidae; Tethya
Nosenko2013_nonribo_9187_Trichoplax_adhaerens	 Metazoa; Placozoa; Trichoplacidae; Trichoplax
Nosenko2013_nonribo_9187_Trichoplax_sp_H4	 Metazoa; Placozoa; Trichoplacidae
Nosenko2013_nonribo_9187_Tubifex_tubifex	 Metazoa; Eumetazoa; Bilateria; Protostomia; Lophotrochozoa; Annelida; Clitellata; Oligochaeta; Haplotaxida; Tubificina; Naididae; Tubificinae; Tubifex
Nosenko2013_nonribo_9187_Xenoturbella_bocki	 Metazoa; Eumetazoa; Bilateria; Xenacoelomorpha; Xenoturbellida; Xenoturbellidae; Xenoturbella
Nosenko2013_ribo_11057_Amphimedon_queenslandica	 Metazoa; Porifera; Demospongiae; Heteroscleromorpha; Haplosclerida; Niphatidae; Amphimedon
Nosenko2013_ribo_11057_Astrosclera_willeyana	 Metazoa; Porifera; Demospongiae; Heteroscleromorpha; Agelasida; Astroscleridae; Astrosclera
Nosenko2013_ribo_11057_Asbestopluma_sp	 Metazoa; Porifera; Demospongiae; Heteroscleromorpha; Poecilosclerida; Cladorhizidae
Nosenko2013_ribo_11057_Carteriospongia_foliascens	 Metazoa; Porifera; Demospongiae; Keratosa; Dictyoceratida; Thorectidae; Carteriospongia
Nosenko2013_ribo_11057_Ephydatia_muelleri	 Metazoa; Porifera; Demospongiae; Heteroscleromorpha; Spongillida; Spongillidae; Ephydatia
Nosenko2013_ribo_11057_Lubomirskia_baicalensis	 Metazoa; Porifera; Demospongiae; Heteroscleromorpha; Spongillida; Lubomirskiidae; Lubomirskia
Nosenko2013_ribo_11057_Pachydictyum_globosum	 Metazoa; Porifera; Demospongiae; Heteroscleromorpha; Spongillida; Lubomirskiidae; Pachydictyum
Nosenko2013_ribo_11057_Suberites_domuncula	 Metazoa; Porifera; Demospongiae; Heteroscleromorpha; Suberitida; Suberitidae; Suberites
Nosenko2013_ribo_11057_Tethya_wilhelma	 Metazoa; Porifera; Demospongiae; Heteroscleromorpha; Tethyida; Tethyidae; Tethya
Nosenko2013_ribo_11057_Crateromorpha_meyeri	 Metazoa; Porifera; Hexactinellida; Hexasterophora; Lyssacinosida; Rossellidae; Crateromorpha
Nosenko2013_ribo_11057_Heterochone_calyx	 Metazoa; Porifera; Hexactinellida; Hexasterophora; Hexactinosida; Sceptrulophora; Aphrocallistidae; Heterochone
Nosenko2013_ribo_11057_Oopsacas_minuta	 Metazoa; Porifera; Hexactinellida; Hexasterophora; Lyssacinosida; Leucopsacidae; Oopsacas
Nosenko2013_ribo_11057_Oscarella_sp	 Metazoa; Porifera; Homoscleromorpha; Homosclerophorida; Plakinidae
Nosenko2013_ribo_11057_Leucetta_chagosensis	 Metazoa; Porifera; Calcarea; Calcinea; Clathrinida; Leucettidae; Leucetta
Nosenko2013_ribo_11057_Sycon_ciliatum	 Metazoa; Porifera; Calcarea; Calcaronea; Leucosolenida; Sycettidae; Sycon
Nosenko2013_ribo_11057_Sycon_raphanus	 Metazoa; Porifera; Calcarea; Calcaronea; Leucosolenida; Sycettidae; Sycon
Nosenko2013_ribo_11057_Clytia_hemisphaerica	 Metazoa; Eumetazoa; Cnidaria; Hydrozoa; Hydroidolina; Leptothecata; Campanulariidae; Clytia
Nosenko2013_ribo_11057_Hydra_magnipapillata	 Metazoa; Eumetazoa; Cnidaria; Hydrozoa; Hydroidolina; Anthoathecata; Aplanulata; Hydridae; Hydra
Nosenko2013_ribo_11057_Hydra_vulgaris	 Metazoa; Eumetazoa; Cnidaria; Hydrozoa; Hydroidolina; Anthoathecata; Aplanulata; Hydridae; Hydra
Nosenko2013_ribo_11057_Hydractinia_echinata	 Metazoa; Eumetazoa; Cnidaria; Hydrozoa; Hydroidolina; Anthoathecata; Filifera; Hydractiniidae; Hydractinia
Nosenko2013_ribo_11057_Podocoryna_carnea	 Metazoa; Eumetazoa; Cnidaria; Hydrozoa; Hydroidolina; Anthoathecata; Filifera; Hydractiniidae; Podocoryna
Nosenko2013_ribo_11057_Acropora_hyacinthus	 Metazoa; Eumetazoa; Cnidaria; Anthozoa; Hexacorallia; Scleractinia; Astrocoeniina; Acroporidae; Acropora
Nosenko2013_ribo_11057_Acropora_millepora	 Metazoa; Eumetazoa; Cnidaria; Anthozoa; Hexacorallia; Scleractinia; Astrocoeniina; Acroporidae; Acropora
Nosenko2013_ribo_11057_Acropora_palmata	 Metazoa; Eumetazoa; Cnidaria; Anthozoa; Hexacorallia; Scleractinia; Astrocoeniina; Acroporidae; Acropora
Nosenko2013_ribo_11057_Metridium_senile	 Metazoa; Eumetazoa; Cnidaria; Anthozoa; Hexacorallia; Actiniaria; Nynantheae; Metridiidae; Metridium
Nosenko2013_ribo_11057_Nematostella_vectensis	 Metazoa; Eumetazoa; Cnidaria; Anthozoa; Hexacorallia; Actiniaria; Edwardsiidae; Nematostella
Nosenko2013_ribo_11057_Porites	 Metazoa; Eumetazoa; Cnidaria; Anthozoa; Hexacorallia; Scleractinia; Fungiina; Poritidae
Nosenko2013_ribo_11057_Pleurobrachia_pileus	 Metazoa; Eumetazoa; Ctenophora; Tentaculata; Cydippida; Pleurobrachiidae; Pleurobrachia
Nosenko2013_ribo_11057_Beroe_sp	 Metazoa; Eumetazoa; Ctenophora; Nuda; Beroida; Beroidae
Nosenko2013_ribo_11057_Mnemiopsis_leidyi	 Metazoa; Eumetazoa; Ctenophora; Tentaculata; Lobata; Bolinopsidae; Mnemiopsis
Nosenko2013_ribo_11057_Mertensiid_sp	 Metazoa; Eumetazoa; Ctenophora; Tentaculata; Cydippida; Mertensiidae; unclassified Mertensiidae
Nosenko2013_ribo_11057_Branchiostoma_floridae	 Metazoa; Eumetazoa; Bilateria; Deuterostomia; Chordata; Cephalochordata; Branchiostomidae; Branchiostoma
Nosenko2013_ribo_11057_Capitella_teleta	 Metazoa; Eumetazoa; Bilateria; Protostomia; Lophotrochozoa; Annelida; Polychaeta; Scolecida; Capitellida; Capitellidae; Capitella
Nosenko2013_ribo_11057_Ciona_intestinalis	 Metazoa; Eumetazoa; Bilateria; Deuterostomia; Chordata; Tunicata; Ascidiacea; Enterogona; Phlebobranchia; Cionidae; Ciona
Nosenko2013_ribo_11057_Danio_rerio	 Metazoa; Eumetazoa; Bilateria; Deuterostomia; Chordata; Craniata; Vertebrata; Gnathostomata; Teleostomi; Euteleostomi; Actinopterygii; Actinopteri; Neopterygii; Teleostei; Osteoglossocephalai; Clupeocephala; Otomorpha; Ostariophysi; Otophysi; Cypriniphysae; Cypriniformes; Cyprinoidea; Cyprinidae; Danio
Nosenko2013_ribo_11057_Molgula_tectiformis	 Metazoa; Eumetazoa; Bilateria; Deuterostomia; Chordata; Tunicata; Ascidiacea; Stolidobranchia; Molgulidae; Molgula
Nosenko2013_ribo_11057_Petromyzon_marinus	 Metazoa; Eumetazoa; Bilateria; Deuterostomia; Chordata; Craniata; Vertebrata; Cyclostomata; Hyperoartia; Petromyzontiformes; Petromyzontidae; Petromyzon
Nosenko2013_ribo_11057_Saccoglossus_kowalevskii	 Metazoa; Eumetazoa; Bilateria; Deuterostomia; Hemichordata; Enteropneusta; Harrimaniidae; Saccoglossus
Nosenko2013_ribo_11057_Aplysia_californica	 Metazoa; Eumetazoa; Bilateria; Protostomia; Lophotrochozoa; Mollusca; Gastropoda; Heterobranchia; Euthyneura; Euopisthobranchia; Aplysiida; Aplysioidea; Aplysiidae; Aplysia
Nosenko2013_ribo_11057_Crassostrea_gigas	 Metazoa; Eumetazoa; Bilateria; Protostomia; Lophotrochozoa; Mollusca; Bivalvia; Pteriomorphia; Ostreoida; Ostreoidea; Ostreidae; Crassostrea
Nosenko2013_ribo_11057_Daphnia_pulex	 Metazoa; Eumetazoa; Bilateria; Protostomia; Ecdysozoa; Panarthropoda; Arthropoda; Mandibulata; Pancrustacea; Crustacea; Branchiopoda; Phyllopoda; Diplostraca; Cladocera; Anomopoda; Daphniidae; Daphnia
Nosenko2013_ribo_11057_Helobdella_robusta	 Metazoa; Eumetazoa; Bilateria; Protostomia; Lophotrochozoa; Annelida; Clitellata; Hirudinea; Hirudinida; Glossiphoniiformes; Glossiphoniidae; Helobdella
Nosenko2013_ribo_11057_Ixodes_scapularis	 Metazoa; Eumetazoa; Bilateria; Protostomia; Ecdysozoa; Panarthropoda; Arthropoda; Chelicerata; Arachnida; Acari; Parasitiformes; Ixodida; Ixodoidea; Ixodidae; Ixodinae; Ixodes
Nosenko2013_ribo_11057_Nasonia_vitripennis	 Metazoa; Eumetazoa; Bilateria; Protostomia; Ecdysozoa; Panarthropoda; Arthropoda; Mandibulata; Pancrustacea; Hexapoda; Insecta; Dicondylia; Pterygota; Neoptera; Holometabola; Hymenoptera; Apocrita; Parasitoida; Chalcidoidea; Pteromalidae; Pteromalinae; Nasonia
Nosenko2013_ribo_11057_Tubifex_tubifex	 Metazoa; Eumetazoa; Bilateria; Protostomia; Lophotrochozoa; Annelida; Clitellata; Oligochaeta; Haplotaxida; Tubificina; Naididae; Tubificinae; Tubifex
Nosenko2013_ribo_11057_Trichoplax_sp_H4	 Metazoa; Placozoa; Trichoplacidae
Nosenko2013_ribo_11057_Trichoplax_adhaerens	 Metazoa; Placozoa; Trichoplacidae; Trichoplax
Nosenko2013_ribo_11057_Monosiga_ovata	 Choanoflagellida; Craspedida; Salpingoecidae; Monosiga
Nosenko2013_ribo_11057_Monosiga_brevicollis	 Choanoflagellida; Craspedida; Salpingoecidae; Monosiga
Nosenko2013_ribo_11057_Proterospongia_sp	 Choanoflagellida; Craspedida; Salpingoecidae
Nosenko2013_ribo_14615_Acropora_hyacinthus	 Metazoa; Eumetazoa; Cnidaria; Anthozoa; Hexacorallia; Scleractinia; Astrocoeniina; Acroporidae; Acropora
Nosenko2013_ribo_14615_Acropora_millepora	 Metazoa; Eumetazoa; Cnidaria; Anthozoa; Hexacorallia; Scleractinia; Astrocoeniina; Acroporidae; Acropora
Nosenko2013_ribo_14615_Acropora_palmata	 Metazoa; Eumetazoa; Cnidaria; Anthozoa; Hexacorallia; Scleractinia; Astrocoeniina; Acroporidae; Acropora
Nosenko2013_ribo_14615_Allomyces_macrogynus	 Fungi; Fungi incertae sedis; Blastocladiomycota; Blastocladiomycetes; Blastocladiales; Blastocladiaceae; Allomyces
Nosenko2013_ribo_14615_Amoebidium_parasiticum	 Opisthokonta incertae sedis; Ichthyosporea; Ichthyophonida; Amoebidiaceae; Amoebidium
Nosenko2013_ribo_14615_Amphimedon_queenslandica	 Metazoa; Porifera; Demospongiae; Heteroscleromorpha; Haplosclerida; Niphatidae; Amphimedon
Nosenko2013_ribo_14615_Anoplodactylus_eroticus	 Metazoa; Eumetazoa; Bilateria; Protostomia; Ecdysozoa; Panarthropoda; Arthropoda; Chelicerata; Pycnogonida; Pantopoda; Phoxichilidiidae; Anoplodactylus
Nosenko2013_ribo_14615_Aplysia_californica	 Metazoa; Eumetazoa; Bilateria; Protostomia; Lophotrochozoa; Mollusca; Gastropoda; Heterobranchia; Euthyneura; Euopisthobranchia; Aplysiida; Aplysioidea; Aplysiidae; Aplysia
Nosenko2013_ribo_14615_Aphrocallistes_vastus	 Metazoa; Porifera; Hexactinellida; Hexasterophora; Hexactinosida; Sceptrulophora; Aphrocallistidae; Aphrocallistes
Nosenko2013_ribo_14615_Asbestopluma_sp	 Metazoa; Porifera; Demospongiae; Heteroscleromorpha; Poecilosclerida; Cladorhizidae
Nosenko2013_ribo_14615_Astrosclera_willeyana	 Metazoa; Porifera; Demospongiae; Heteroscleromorpha; Agelasida; Astroscleridae; Astrosclera
Nosenko2013_ribo_14615_Batrachochytrium_dendrobatidis	 Fungi; Fungi incertae sedis; Chytridiomycota; Chytridiomycetes; Rhizophydiales; Rhizophydiales incertae sedis; Batrachochytrium
Nosenko2013_ribo_14615_Beroe_sp	 Metazoa; Eumetazoa; Ctenophora; Nuda; Beroida; Beroidae
Nosenko2013_ribo_14615_Branchiostoma_floridae	 Metazoa; Eumetazoa; Bilateria; Deuterostomia; Chordata; Cephalochordata; Branchiostomidae; Branchiostoma
Nosenko2013_ribo_14615_Capitella_teleta	 Metazoa; Eumetazoa; Bilateria; Protostomia; Lophotrochozoa; Annelida; Polychaeta; Scolecida; Capitellida; Capitellidae; Capitella
Nosenko2013_ribo_14615_Capsaspora_owczarzaki	 Opisthokonta incertae sedis; Ichthyosporea; Capsaspora
Nosenko2013_ribo_14615_Carteriospongia_foliascens	 Metazoa; Porifera; Demospongiae; Keratosa; Dictyoceratida; Thorectidae; Carteriospongia
Nosenko2013_ribo_14615_Ciona_intestinalis	 Metazoa; Eumetazoa; Bilateria; Deuterostomia; Chordata; Tunicata; Ascidiacea; Enterogona; Phlebobranchia; Cionidae; Ciona
Nosenko2013_ribo_14615_Clytia_hemisphaerica	 Metazoa; Eumetazoa; Cnidaria; Hydrozoa; Hydroidolina; Leptothecata; Campanulariidae; Clytia
Nosenko2013_ribo_14615_Corticium	 Fungi; Dikarya; Basidiomycota; Agaricomycotina; Agaricomycetes; Agaricomycetes incertae sedis; Corticiales; Corticiaceae
Nosenko2013_ribo_14615_Crassostrea_gigas	 Metazoa; Eumetazoa; Bilateria; Protostomia; Lophotrochozoa; Mollusca; Bivalvia; Pteriomorphia; Ostreoida; Ostreoidea; Ostreidae; Crassostrea
Nosenko2013_ribo_14615_Crateromorpha_meyeri	 Metazoa; Porifera; Hexactinellida; Hexasterophora; Lyssacinosida; Rossellidae; Crateromorpha
Nosenko2013_ribo_14615_Cyanea_capillata	 Metazoa; Eumetazoa; Cnidaria; Scyphozoa; Semaeostomeae; Cyaneidae; Cyanea
Nosenko2013_ribo_14615_Danio_rerio	 Metazoa; Eumetazoa; Bilateria; Deuterostomia; Chordata; Craniata; Vertebrata; Gnathostomata; Teleostomi; Euteleostomi; Actinopterygii; Actinopteri; Neopterygii; Teleostei; Osteoglossocephalai; Clupeocephala; Otomorpha; Ostariophysi; Otophysi; Cypriniphysae; Cypriniformes; Cyprinoidea; Cyprinidae; Danio
Nosenko2013_ribo_14615_Daphnia_pulex	 Metazoa; Eumetazoa; Bilateria; Protostomia; Ecdysozoa; Panarthropoda; Arthropoda; Mandibulata; Pancrustacea; Crustacea; Branchiopoda; Phyllopoda; Diplostraca; Cladocera; Anomopoda; Daphniidae; Daphnia
Nosenko2013_ribo_14615_Ephydatia_muelleri	 Metazoa; Porifera; Demospongiae; Heteroscleromorpha; Spongillida; Spongillidae; Ephydatia
Nosenko2013_ribo_14615_Euprymna_scolopes	 Metazoa; Eumetazoa; Bilateria; Protostomia; Lophotrochozoa; Mollusca; Cephalopoda; Coleoidea; Neocoleoidea; Decapodiformes; Sepiolida; Sepiolidae; Sepiolinae; Euprymna
Nosenko2013_ribo_14615_Helobdella_robusta	 Metazoa; Eumetazoa; Bilateria; Protostomia; Lophotrochozoa; Annelida; Clitellata; Hirudinea; Hirudinida; Glossiphoniiformes; Glossiphoniidae; Helobdella
Nosenko2013_ribo_14615_Heterochone_calyx	 Metazoa; Porifera; Hexactinellida; Hexasterophora; Hexactinosida; Sceptrulophora; Aphrocallistidae; Heterochone
Nosenko2013_ribo_14615_Hydra_magnipapillata	 Metazoa; Eumetazoa; Cnidaria; Hydrozoa; Hydroidolina; Anthoathecata; Aplanulata; Hydridae; Hydra
Nosenko2013_ribo_14615_Hydra_vulgaris	 Metazoa; Eumetazoa; Cnidaria; Hydrozoa; Hydroidolina; Anthoathecata; Aplanulata; Hydridae; Hydra
Nosenko2013_ribo_14615_Hydractinia_echinata	 Metazoa; Eumetazoa; Cnidaria; Hydrozoa; Hydroidolina; Anthoathecata; Filifera; Hydractiniidae; Hydractinia
Nosenko2013_ribo_14615_Ixodes_scapularis	 Metazoa; Eumetazoa; Bilateria; Protostomia; Ecdysozoa; Panarthropoda; Arthropoda; Chelicerata; Arachnida; Acari; Parasitiformes; Ixodida; Ixodoidea; Ixodidae; Ixodinae; Ixodes
Nosenko2013_ribo_14615_Leucetta_chagosensis	 Metazoa; Porifera; Calcarea; Calcinea; Clathrinida; Leucettidae; Leucetta
Nosenko2013_ribo_14615_Leucosolenia_sp	 Metazoa; Porifera; Calcarea; Calcaronea; Leucosolenida; Leucosoleniidae
Nosenko2013_ribo_14615_Lubomirskia_baicalensis	 Metazoa; Porifera; Demospongiae; Heteroscleromorpha; Spongillida; Lubomirskiidae; Lubomirskia
Nosenko2013_ribo_14615_Mertensiid_sp	 Metazoa; Eumetazoa; Ctenophora; Tentaculata; Cydippida; Mertensiidae; unclassified Mertensiidae
Nosenko2013_ribo_14615_Metridium_senile	 Metazoa; Eumetazoa; Cnidaria; Anthozoa; Hexacorallia; Actiniaria; Nynantheae; Metridiidae; Metridium
Nosenko2013_ribo_14615_Mnemiopsis_leidyi	 Metazoa; Eumetazoa; Ctenophora; Tentaculata; Lobata; Bolinopsidae; Mnemiopsis
Nosenko2013_ribo_14615_Molgula_tectiformis	 Metazoa; Eumetazoa; Bilateria; Deuterostomia; Chordata; Tunicata; Ascidiacea; Stolidobranchia; Molgulidae; Molgula
Nosenko2013_ribo_14615_Monosiga_brevicollis	 Choanoflagellida; Craspedida; Salpingoecidae; Monosiga
Nosenko2013_ribo_14615_Monosiga_ovata	 Choanoflagellida; Craspedida; Salpingoecidae; Monosiga
Nosenko2013_ribo_14615_Montastraea_faveolata	 Metazoa; Eumetazoa; Cnidaria; Anthozoa; Hexacorallia; Scleractinia; Faviina; Merulinidae; Orbicella
Nosenko2013_ribo_14615_Nasonia_vitripennis	 Metazoa; Eumetazoa; Bilateria; Protostomia; Ecdysozoa; Panarthropoda; Arthropoda; Mandibulata; Pancrustacea; Hexapoda; Insecta; Dicondylia; Pterygota; Neoptera; Holometabola; Hymenoptera; Apocrita; Parasitoida; Chalcidoidea; Pteromalidae; Pteromalinae; Nasonia
Nosenko2013_ribo_14615_Nematostella_vectensis	 Metazoa; Eumetazoa; Cnidaria; Anthozoa; Hexacorallia; Actiniaria; Edwardsiidae; Nematostella
Nosenko2013_ribo_14615_Oopsacas_minuta	 Metazoa; Porifera; Hexactinellida; Hexasterophora; Lyssacinosida; Leucopsacidae; Oopsacas
Nosenko2013_ribo_14615_Oscarella_carmela	 Metazoa; Porifera; Homoscleromorpha; Homosclerophorida; Plakinidae; Oscarella
Nosenko2013_ribo_14615_Oscarella_lobularis	 Metazoa; Porifera; Homoscleromorpha; Homosclerophorida; Plakinidae; Oscarella
Nosenko2013_ribo_14615_Oscarella_sp	 Metazoa; Porifera; Homoscleromorpha; Homosclerophorida; Plakinidae
Nosenko2013_ribo_14615_Pachydictyum_globosum	 Metazoa; Porifera; Demospongiae; Heteroscleromorpha; Spongillida; Lubomirskiidae; Pachydictyum
Nosenko2013_ribo_14615_Pedicellina_cernua	 Metazoa; Eumetazoa; Bilateria; Protostomia; Lophotrochozoa; Entoprocta; Pedicellinidae; Pedicellina
Nosenko2013_ribo_14615_Pediculus_humanus_capitis	 Metazoa; Eumetazoa; Bilateria; Protostomia; Ecdysozoa; Panarthropoda; Arthropoda; Mandibulata; Pancrustacea; Hexapoda; Insecta; Dicondylia; Pterygota; Neoptera; Paraneoptera; Psocodea; Phthiraptera; Anoplura; Pediculidae; Pediculus; Pediculus humanus
Nosenko2013_ribo_14615_Petromyzon_marinus	 Metazoa; Eumetazoa; Bilateria; Deuterostomia; Chordata; Craniata; Vertebrata; Cyclostomata; Hyperoartia; Petromyzontiformes; Petromyzontidae; Petromyzon
Nosenko2013_ribo_14615_Phycomyces_blakesleeanus	 Fungi; Fungi incertae sedis; Mucoromycota; Mucoromycotina; Mucoromycetes; Mucorales; Phycomycetaceae; Phycomyces
Nosenko2013_ribo_14615_Pleurobrachia_pileus	 Metazoa; Eumetazoa; Ctenophora; Tentaculata; Cydippida; Pleurobrachiidae; Pleurobrachia
Nosenko2013_ribo_14615_Podocoryna_carnea	 Metazoa; Eumetazoa; Cnidaria; Hydrozoa; Hydroidolina; Anthoathecata; Filifera; Hydractiniidae; Podocoryna
Nosenko2013_ribo_14615_Porites	 Metazoa; Eumetazoa; Cnidaria; Anthozoa; Hexacorallia; Scleractinia; Fungiina; Poritidae
Nosenko2013_ribo_14615_Proterospongia_sp	 Choanoflagellida; Craspedida; Salpingoecidae
Nosenko2013_ribo_14615_Saccoglossus_kowalevskii	 Metazoa; Eumetazoa; Bilateria; Deuterostomia; Hemichordata; Enteropneusta; Harrimaniidae; Saccoglossus
Nosenko2013_ribo_14615_Scutigera_coleoptrata	 Metazoa; Eumetazoa; Bilateria; Protostomia; Ecdysozoa; Panarthropoda; Arthropoda; Mandibulata; Myriapoda; Chilopoda; Notostigmophora; Scutigeromorpha; Scutigeridae; Scutigera
Nosenko2013_ribo_14615_Spizellomyces_punctatus	 Fungi; Fungi incertae sedis; Chytridiomycota; Chytridiomycetes; Spizellomycetales; Spizellomycetaceae; Spizellomyces
Nosenko2013_ribo_14615_Sphaeroforma_arctica	 Opisthokonta incertae sedis; Ichthyosporea; Ichthyophonida; Sphaeroforma
Nosenko2013_ribo_14615_Strongylocentrotus_purpuratus	 Metazoa; Eumetazoa; Bilateria; Deuterostomia; Echinodermata; Eleutherozoa; Echinozoa; Echinoidea; Euechinoidea; Echinacea; Echinoida; Strongylocentrotidae; Strongylocentrotus
Nosenko2013_ribo_14615_Suberites_fuscus	 Metazoa; Porifera; Demospongiae; Heteroscleromorpha; Suberitida; Suberitidae; Suberites
Nosenko2013_ribo_14615_Suberites_domuncula	 Metazoa; Porifera; Demospongiae; Heteroscleromorpha; Suberitida; Suberitidae; Suberites
Nosenko2013_ribo_14615_Sycon_raphanus	 Metazoa; Porifera; Calcarea; Calcaronea; Leucosolenida; Sycettidae; Sycon
Nosenko2013_ribo_14615_Tethya_wilhelma	 Metazoa; Porifera; Demospongiae; Heteroscleromorpha; Tethyida; Tethyidae; Tethya
Nosenko2013_ribo_14615_Trichoplax_adhaerens	 Metazoa; Placozoa; Trichoplacidae; Trichoplax
Nosenko2013_ribo_14615_Trichoplax_sp_H4	 Metazoa; Placozoa; Trichoplacidae
Nosenko2013_ribo_14615_Tubifex_tubifex	 Metazoa; Eumetazoa; Bilateria; Protostomia; Lophotrochozoa; Annelida; Clitellata; Oligochaeta; Haplotaxida; Tubificina; Naididae; Tubificinae; Tubifex
Nosenko2013_ribo_14615_Xenoturbella_bocki	 Metazoa; Eumetazoa; Bilateria; Xenacoelomorpha; Xenoturbellida; Xenoturbellidae; Xenoturbella
Philippe2009_Acropora_millepora	 Metazoa; Eumetazoa; Cnidaria; Anthozoa; Hexacorallia; Scleractinia; Astrocoeniina; Acroporidae; Acropora
Philippe2009_Allomyces_macrogynus	 Fungi; Fungi incertae sedis; Blastocladiomycota; Blastocladiomycetes; Blastocladiales; Blastocladiaceae; Allomyces
Philippe2009_Amoebidium_parasiticum	 Opisthokonta incertae sedis; Ichthyosporea; Ichthyophonida; Amoebidiaceae; Amoebidium
Philippe2009_Anoplodactylus_eroticus	 Metazoa; Eumetazoa; Bilateria; Protostomia; Ecdysozoa; Panarthropoda; Arthropoda; Chelicerata; Pycnogonida; Pantopoda; Phoxichilidiidae; Anoplodactylus
Philippe2009_Aplysia_californica	 Metazoa; Eumetazoa; Bilateria; Protostomia; Lophotrochozoa; Mollusca; Gastropoda; Heterobranchia; Euthyneura; Euopisthobranchia; Aplysiida; Aplysioidea; Aplysiidae; Aplysia
Philippe2009_Batrachochytrium_dendrobatidis	 Fungi; Fungi incertae sedis; Chytridiomycota; Chytridiomycetes; Rhizophydiales; Rhizophydiales incertae sedis; Batrachochytrium
Philippe2009_Branchiostoma_floridae	 Metazoa; Eumetazoa; Bilateria; Deuterostomia; Chordata; Cephalochordata; Branchiostomidae; Branchiostoma
Philippe2009_Capitella_teleta	 Metazoa; Eumetazoa; Bilateria; Protostomia; Lophotrochozoa; Annelida; Polychaeta; Scolecida; Capitellida; Capitellidae; Capitella
Philippe2009_Capsaspora_owczarzaki	 Opisthokonta incertae sedis; Ichthyosporea; Capsaspora
Philippe2009_Carteriospongia_foliascens	 Metazoa; Porifera; Demospongiae; Keratosa; Dictyoceratida; Thorectidae; Carteriospongia
Philippe2009_Ciona_savignyi	 Metazoa; Eumetazoa; Bilateria; Deuterostomia; Chordata; Tunicata; Ascidiacea; Enterogona; Phlebobranchia; Cionidae; Ciona
Philippe2009_Clytia_hemisphaerica	 Metazoa; Eumetazoa; Cnidaria; Hydrozoa; Hydroidolina; Leptothecata; Campanulariidae; Clytia
Philippe2009_Crassostrea_gigas	 Metazoa; Eumetazoa; Bilateria; Protostomia; Lophotrochozoa; Mollusca; Bivalvia; Pteriomorphia; Ostreoida; Ostreoidea; Ostreidae; Crassostrea
Philippe2009_Cyanea_capillata	 Metazoa; Eumetazoa; Cnidaria; Scyphozoa; Semaeostomeae; Cyaneidae; Cyanea
Philippe2009_Danio_rerio	 Metazoa; Eumetazoa; Bilateria; Deuterostomia; Chordata; Craniata; Vertebrata; Gnathostomata; Teleostomi; Euteleostomi; Actinopterygii; Actinopteri; Neopterygii; Teleostei; Osteoglossocephalai; Clupeocephala; Otomorpha; Ostariophysi; Otophysi; Cypriniphysae; Cypriniformes; Cyprinoidea; Cyprinidae; Danio
Philippe2009_Daphnia_pulex	 Metazoa; Eumetazoa; Bilateria; Protostomia; Ecdysozoa; Panarthropoda; Arthropoda; Mandibulata; Pancrustacea; Crustacea; Branchiopoda; Phyllopoda; Diplostraca; Cladocera; Anomopoda; Daphniidae; Daphnia
Philippe2009_Ephydatia_muelleri	 Metazoa; Porifera; Demospongiae; Heteroscleromorpha; Spongillida; Spongillidae; Ephydatia
Philippe2009_Euperipatoides_kanangrensis	 Metazoa; Eumetazoa; Bilateria; Protostomia; Ecdysozoa; Panarthropoda; Onychophora; Udeonychophora; Euonychophora; Peripatopsidae; Euperipatoides
Philippe2009_Euprymna_scolopes	 Metazoa; Eumetazoa; Bilateria; Protostomia; Lophotrochozoa; Mollusca; Cephalopoda; Coleoidea; Neocoleoidea; Decapodiformes; Sepiolida; Sepiolidae; Sepiolinae; Euprymna
Philippe2009_Helobdella_robusta	 Metazoa; Eumetazoa; Bilateria; Protostomia; Lophotrochozoa; Annelida; Clitellata; Hirudinea; Hirudinida; Glossiphoniiformes; Glossiphoniidae; Helobdella
Philippe2009_Heterochone_sp	 Metazoa; Porifera; Hexactinellida; Hexasterophora; Hexactinosida; Sceptrulophora; Aphrocallistidae
Philippe2009_Hydra_magnipapillata	 Metazoa; Eumetazoa; Cnidaria; Hydrozoa; Hydroidolina; Anthoathecata; Aplanulata; Hydridae; Hydra
Philippe2009_Hydractinia_echinata	 Metazoa; Eumetazoa; Cnidaria; Hydrozoa; Hydroidolina; Anthoathecata; Filifera; Hydractiniidae; Hydractinia
Philippe2009_Ixodes_scapularis	 Metazoa; Eumetazoa; Bilateria; Protostomia; Ecdysozoa; Panarthropoda; Arthropoda; Chelicerata; Arachnida; Acari; Parasitiformes; Ixodida; Ixodoidea; Ixodidae; Ixodinae; Ixodes
Philippe2009_Leucetta_chagosensis	 Metazoa; Porifera; Calcarea; Calcinea; Clathrinida; Leucettidae; Leucetta
Philippe2009_Metridium_senile	 Metazoa; Eumetazoa; Cnidaria; Anthozoa; Hexacorallia; Actiniaria; Nynantheae; Metridiidae; Metridium
Philippe2009_Mnemiopsis_leidyi	 Metazoa; Eumetazoa; Ctenophora; Tentaculata; Lobata; Bolinopsidae; Mnemiopsis
Philippe2009_Molgula_tectiformis	 Metazoa; Eumetazoa; Bilateria; Deuterostomia; Chordata; Tunicata; Ascidiacea; Stolidobranchia; Molgulidae; Molgula
Philippe2009_Monosiga_brevicollis	 Choanoflagellida; Craspedida; Salpingoecidae; Monosiga
Philippe2009_Monosiga_ovata	 Choanoflagellida; Craspedida; Salpingoecidae; Monosiga
Philippe2009_Montastraea_faveolata	 Metazoa; Eumetazoa; Cnidaria; Anthozoa; Hexacorallia; Scleractinia; Faviina; Merulinidae; Orbicella
Philippe2009_Nasonia_vitripennis	 Metazoa; Eumetazoa; Bilateria; Protostomia; Ecdysozoa; Panarthropoda; Arthropoda; Mandibulata; Pancrustacea; Hexapoda; Insecta; Dicondylia; Pterygota; Neoptera; Holometabola; Hymenoptera; Apocrita; Parasitoida; Chalcidoidea; Pteromalidae; Pteromalinae; Nasonia
Philippe2009_Nematostella_vectensis	 Metazoa; Eumetazoa; Cnidaria; Anthozoa; Hexacorallia; Actiniaria; Edwardsiidae; Nematostella
Philippe2009_Oopsacas_minuta	 Metazoa; Porifera; Hexactinellida; Hexasterophora; Lyssacinosida; Leucopsacidae; Oopsacas
Philippe2009_Oscarella_carmela	 Metazoa; Porifera; Homoscleromorpha; Homosclerophorida; Plakinidae; Oscarella
Philippe2009_Pedicellina_cernua	 Metazoa; Eumetazoa; Bilateria; Protostomia; Lophotrochozoa; Entoprocta; Pedicellinidae; Pedicellina
Philippe2009_Pediculus_humanus	 Metazoa; Eumetazoa; Bilateria; Protostomia; Ecdysozoa; Panarthropoda; Arthropoda; Mandibulata; Pancrustacea; Hexapoda; Insecta; Dicondylia; Pterygota; Neoptera; Paraneoptera; Psocodea; Phthiraptera; Anoplura; Pediculidae; Pediculus
Philippe2009_Petromyzon_marinus	 Metazoa; Eumetazoa; Bilateria; Deuterostomia; Chordata; Craniata; Vertebrata; Cyclostomata; Hyperoartia; Petromyzontiformes; Petromyzontidae; Petromyzon
Philippe2009_Phycomyces_blakesleeanus	 Fungi; Fungi incertae sedis; Mucoromycota; Mucoromycotina; Mucoromycetes; Mucorales; Phycomycetaceae; Phycomyces
Philippe2009_Pleurobrachia_pileus	 Metazoa; Eumetazoa; Ctenophora; Tentaculata; Cydippida; Pleurobrachiidae; Pleurobrachia
Philippe2009_Podocoryne_carnea	 Metazoa; Eumetazoa; Cnidaria; Hydrozoa; Hydroidolina; Anthoathecata; Filifera; Hydractiniidae; Podocoryna
Philippe2009_Proterospongia_sp	 Choanoflagellida; Craspedida; Salpingoecidae
Philippe2009_Amphimedon_queenslandica	 Metazoa; Porifera; Demospongiae; Heteroscleromorpha; Haplosclerida; Niphatidae; Amphimedon
Philippe2009_Rhizopus_oryzae	 Fungi; Fungi incertae sedis; Mucoromycota; Mucoromycotina; Mucoromycetes; Mucorales; Mucorineae; Rhizopodaceae; Rhizopus
Philippe2009_Saccoglossus_kowalevskii	 Metazoa; Eumetazoa; Bilateria; Deuterostomia; Hemichordata; Enteropneusta; Harrimaniidae; Saccoglossus
Philippe2009_Scutigera_coleoptrata	 Metazoa; Eumetazoa; Bilateria; Protostomia; Ecdysozoa; Panarthropoda; Arthropoda; Mandibulata; Myriapoda; Chilopoda; Notostigmophora; Scutigeromorpha; Scutigeridae; Scutigera
Philippe2009_Sphaeroforma_arctica	 Opisthokonta incertae sedis; Ichthyosporea; Ichthyophonida; Sphaeroforma
Philippe2009_Spizellomyces_punctatus	 Fungi; Fungi incertae sedis; Chytridiomycota; Chytridiomycetes; Spizellomycetales; Spizellomycetaceae; Spizellomyces
Philippe2009_Strongylocentrotus_purpuratus	 Metazoa; Eumetazoa; Bilateria; Deuterostomia; Echinodermata; Eleutherozoa; Echinozoa; Echinoidea; Euechinoidea; Echinacea; Echinoida; Strongylocentrotidae; Strongylocentrotus
Philippe2009_Suberites_domuncula	 Metazoa; Porifera; Demospongiae; Heteroscleromorpha; Suberitida; Suberitidae; Suberites
Philippe2009_Sycon_raphanus	 Metazoa; Porifera; Calcarea; Calcaronea; Leucosolenida; Sycettidae; Sycon
Philippe2009_Trichoplax_adhaerens	 Metazoa; Placozoa; Trichoplacidae; Trichoplax
Philippe2009_Tubifex_tubifex	 Metazoa; Eumetazoa; Bilateria; Protostomia; Lophotrochozoa; Annelida; Clitellata; Oligochaeta; Haplotaxida; Tubificina; Naididae; Tubificinae; Tubifex
Philippe2009_Xenoturbella_bocki	 Metazoa; Eumetazoa; Bilateria; Xenacoelomorpha; Xenoturbellida; Xenoturbellidae; Xenoturbella
Philippe2009_Mertensiid_sp	 Metazoa; Eumetazoa; Ctenophora; Tentaculata; Cydippida; Mertensiidae; unclassified Mertensiidae
Ryan2013_est_Oscarella_carmela	 Metazoa; Porifera; Homoscleromorpha; Homosclerophorida; Plakinidae; Oscarella
Ryan2013_est_Asterina_pectinifera	 Metazoa; Eumetazoa; Bilateria; Deuterostomia; Echinodermata; Eleutherozoa; Asterozoa; Asteroidea; Valvatacea; Valvatida; Asterinidae; Patiria
Ryan2013_est_Strongylocentrotus_purpuratus	 Metazoa; Eumetazoa; Bilateria; Deuterostomia; Echinodermata; Eleutherozoa; Echinozoa; Echinoidea; Euechinoidea; Echinacea; Echinoida; Strongylocentrotidae; Strongylocentrotus
Ryan2013_est_Capitella_teleta	 Metazoa; Eumetazoa; Bilateria; Protostomia; Lophotrochozoa; Annelida; Polychaeta; Scolecida; Capitellida; Capitellidae; Capitella
Ryan2013_est_Branchiostoma_floridae	 Metazoa; Eumetazoa; Bilateria; Deuterostomia; Chordata; Cephalochordata; Branchiostomidae; Branchiostoma
Ryan2013_est_Helobdella_robusta	 Metazoa; Eumetazoa; Bilateria; Protostomia; Lophotrochozoa; Annelida; Clitellata; Hirudinea; Hirudinida; Glossiphoniiformes; Glossiphoniidae; Helobdella
Ryan2013_est_Lottia_gigantea	 Metazoa; Eumetazoa; Bilateria; Protostomia; Lophotrochozoa; Mollusca; Gastropoda; Patellogastropoda; Lottioidea; Lottiidae; Lottia
Ryan2013_est_Saccoglossus_kowalevskii	 Metazoa; Eumetazoa; Bilateria; Deuterostomia; Hemichordata; Enteropneusta; Harrimaniidae; Saccoglossus
Ryan2013_est_Drosophila_melanogaster	 Metazoa; Eumetazoa; Bilateria; Protostomia; Ecdysozoa; Panarthropoda; Arthropoda; Mandibulata; Pancrustacea; Hexapoda; Insecta; Dicondylia; Pterygota; Neoptera; Holometabola; Diptera; Brachycera; Muscomorpha; Eremoneura; Cyclorrhapha; Schizophora; Acalyptratae; Ephydroidea; Drosophilidae; Drosophilinae; Drosophilini; Drosophila; Sophophora; melanogaster group; melanogaster subgroup
Ryan2013_est_Anoplodactylus_eroticus	 Metazoa; Eumetazoa; Bilateria; Protostomia; Ecdysozoa; Panarthropoda; Arthropoda; Chelicerata; Pycnogonida; Pantopoda; Phoxichilidiidae; Anoplodactylus
Ryan2013_est_Daphnia_pulex	 Metazoa; Eumetazoa; Bilateria; Protostomia; Ecdysozoa; Panarthropoda; Arthropoda; Mandibulata; Pancrustacea; Crustacea; Branchiopoda; Phyllopoda; Diplostraca; Cladocera; Anomopoda; Daphniidae; Daphnia
Ryan2013_est_Petromyzon_marinus	 Metazoa; Eumetazoa; Bilateria; Deuterostomia; Chordata; Craniata; Vertebrata; Cyclostomata; Hyperoartia; Petromyzontiformes; Petromyzontidae; Petromyzon
Ryan2013_est_Ciona_intestinalis	 Metazoa; Eumetazoa; Bilateria; Deuterostomia; Chordata; Tunicata; Ascidiacea; Enterogona; Phlebobranchia; Cionidae; Ciona
Ryan2013_est_Acropora_palmata	 Metazoa; Eumetazoa; Cnidaria; Anthozoa; Hexacorallia; Scleractinia; Astrocoeniina; Acroporidae; Acropora
Ryan2013_est_Acropora_millepora	 Metazoa; Eumetazoa; Cnidaria; Anthozoa; Hexacorallia; Scleractinia; Astrocoeniina; Acroporidae; Acropora
Ryan2013_est_Nematostella_vectensis	 Metazoa; Eumetazoa; Cnidaria; Anthozoa; Hexacorallia; Actiniaria; Edwardsiidae; Nematostella
Ryan2013_est_Anemonia_viridis	 Metazoa; Eumetazoa; Cnidaria; Anthozoa; Hexacorallia; Actiniaria; Actiniidae; Anemonia
Ryan2013_est_Capsaspora_owczarzaki	 Opisthokonta incertae sedis; Ichthyosporea; Capsaspora
Ryan2013_est_Saccharomyces_cerevisiae	 Fungi; Dikarya; Ascomycota; saccharomyceta; Saccharomycotina; Saccharomycetes; Saccharomycetales; Saccharomycetaceae; Saccharomyces
Ryan2013_est_Cryptococcus_neoformans	 Fungi; Dikarya; Basidiomycota; Agaricomycotina; Tremellomycetes; Tremellales; Cryptococcaceae; Cryptococcus; Cryptococcus neoformans species complex
Ryan2013_est_Monosiga_brevicollis	 Choanoflagellida; Craspedida; Salpingoecidae; Monosiga
Ryan2013_est_Phycomyces_blakesleeanus	 Fungi; Fungi incertae sedis; Mucoromycota; Mucoromycotina; Mucoromycetes; Mucorales; Phycomycetaceae; Phycomyces
Ryan2013_est_Batrachochytrium_dendrobatidis	 Fungi; Fungi incertae sedis; Chytridiomycota; Chytridiomycetes; Rhizophydiales; Rhizophydiales incertae sedis; Batrachochytrium
Ryan2013_est_Spizellomyces_punctatus	 Fungi; Fungi incertae sedis; Chytridiomycota; Chytridiomycetes; Spizellomycetales; Spizellomycetaceae; Spizellomyces
Ryan2013_est_Salpingoeca_rosetta	 Choanoflagellida; Craspedida; Salpingoecidae; Salpingoeca
Ryan2013_est_Amphimedon_queenslandica	 Metazoa; Porifera; Demospongiae; Heteroscleromorpha; Haplosclerida; Niphatidae; Amphimedon
Ryan2013_est_Lubomirskia_baicalensis	 Metazoa; Porifera; Demospongiae; Heteroscleromorpha; Spongillida; Lubomirskiidae; Lubomirskia
Ryan2013_est_Mnemiopsis_leidyi	 Metazoa; Eumetazoa; Ctenophora; Tentaculata; Lobata; Bolinopsidae; Mnemiopsis
Ryan2013_est_Hydra_vulgaris_01	 Metazoa; Eumetazoa; Cnidaria; Hydrozoa; Hydroidolina; Anthoathecata; Aplanulata; Hydridae; Hydra
Ryan2013_est_Trichoplax_adhaerens	 Metazoa; Placozoa; Trichoplacidae; Trichoplax
Ryan2013_est_Cyanea_capillata	 Metazoa; Eumetazoa; Cnidaria; Scyphozoa; Semaeostomeae; Cyaneidae; Cyanea
Ryan2013_est_Crassostrea_virginica	 Metazoa; Eumetazoa; Bilateria; Protostomia; Lophotrochozoa; Mollusca; Bivalvia; Pteriomorphia; Ostreoida; Ostreoidea; Ostreidae; Crassostrea
Ryan2013_est_Schmidtea_mediterranea	 Metazoa; Eumetazoa; Bilateria; Platyhelminthes; Rhabditophora; Seriata; Tricladida; Continenticola; Geoplanoidea; Dugesiidae; Schmidtea
Ryan2013_est_Cerebratulus_lacteus	 Metazoa; Eumetazoa; Bilateria; Protostomia; Lophotrochozoa; Nemertea; Pilidiophora; Heteronemertea; Cerebratulidae; Cerebratulus
Ryan2013_est_Ephydatia_muelleri	 Metazoa; Porifera; Demospongiae; Heteroscleromorpha; Spongillida; Spongillidae; Ephydatia
Ryan2013_est_Pleurobrachia_pileus	 Metazoa; Eumetazoa; Ctenophora; Tentaculata; Cydippida; Pleurobrachiidae; Pleurobrachia
Ryan2013_est_Suberites_domuncula	 Metazoa; Porifera; Demospongiae; Heteroscleromorpha; Suberitida; Suberitidae; Suberites
Ryan2013_est_Hydractinia_echinata	 Metazoa; Eumetazoa; Cnidaria; Hydrozoa; Hydroidolina; Anthoathecata; Filifera; Hydractiniidae; Hydractinia
Ryan2013_est_Clytia_hemisphaerica	 Metazoa; Eumetazoa; Cnidaria; Hydrozoa; Hydroidolina; Leptothecata; Campanulariidae; Clytia
Ryan2013_est_Metridium_senile	 Metazoa; Eumetazoa; Cnidaria; Anthozoa; Hexacorallia; Actiniaria; Nynantheae; Metridiidae; Metridium
Ryan2013_est_Porites_astreoides	 Metazoa; Eumetazoa; Cnidaria; Anthozoa; Hexacorallia; Scleractinia; Fungiina; Poritidae; Porites
Ryan2013_est_Orbicella_faveolata	 Metazoa; Eumetazoa; Cnidaria; Anthozoa; Hexacorallia; Scleractinia; Faviina; Merulinidae; Orbicella
Ryan2013_est_Halocynthia_roretzi	 Metazoa; Eumetazoa; Bilateria; Deuterostomia; Chordata; Tunicata; Ascidiacea; Stolidobranchia; Pyuridae; Halocynthia
Ryan2013_est_Euprymna_scolopes	 Metazoa; Eumetazoa; Bilateria; Protostomia; Lophotrochozoa; Mollusca; Cephalopoda; Coleoidea; Neocoleoidea; Decapodiformes; Sepiolida; Sepiolidae; Sepiolinae; Euprymna
Ryan2013_est_Boophilus_microplus	 Metazoa; Eumetazoa; Bilateria; Protostomia; Ecdysozoa; Panarthropoda; Arthropoda; Chelicerata; Arachnida; Acari; Parasitiformes; Ixodida; Ixodoidea; Ixodidae; Rhipicephalinae; Rhipicephalus; Boophilus
Ryan2013_est_Isodiametra_pulchra	 Metazoa; Eumetazoa; Bilateria; Xenacoelomorpha; Acoelomorpha; Acoela; Isodiametridae; Isodiametra
Ryan2013_est_Symsagittifera_roscoffensis	 Metazoa; Eumetazoa; Bilateria; Xenacoelomorpha; Acoelomorpha; Acoela; Sagittiferidae; Symsagittifera
Ryan2013_est_Monosiga_ovata	 Choanoflagellida; Craspedida; Salpingoecidae; Monosiga
Ryan2013_est_Oscarella_lobularis	 Metazoa; Porifera; Homoscleromorpha; Homosclerophorida; Plakinidae; Oscarella
Ryan2013_est_Gallus_gallus	 Metazoa; Eumetazoa; Bilateria; Deuterostomia; Chordata; Craniata; Vertebrata; Gnathostomata; Teleostomi; Euteleostomi; Sarcopterygii; Dipnotetrapodomorpha; Tetrapoda; Amniota; Sauropsida; Sauria; Archelosauria; Archosauria; Dinosauria; Saurischia; Theropoda; Coelurosauria; Aves; Neognathae; Galloanserae; Galliformes; Phasianidae; Phasianinae; Gallus
Ryan2013_est_Meara_stichopi	 Metazoa; Eumetazoa; Bilateria; Xenacoelomorpha; Acoelomorpha; Nemertodermatida; Nemertodermatidae; Meara
Ryan2013_est_Terebratalia_transversa	 Metazoa; Eumetazoa; Bilateria; Protostomia; Lophotrochozoa; Brachiopoda; Rhynchonelliformea; Rhynchonellata; Terebratulida; Terebratellidina; Laqueoidea; Laqueidae; Terebratalia
Ryan2013_est_Euperipatoides_kanangrensis	 Metazoa; Eumetazoa; Bilateria; Protostomia; Ecdysozoa; Panarthropoda; Onychophora; Udeonychophora; Euonychophora; Peripatopsidae; Euperipatoides
Ryan2013_est_Xiphinema_index	 Metazoa; Eumetazoa; Bilateria; Protostomia; Ecdysozoa; Nematoda; Enoplea; Dorylaimia; Dorylaimida; Dorylaimina; Longidoroidea; Longidoridae; Xiphinema
Ryan2013_est_Oopsacas_minuta	 Metazoa; Porifera; Hexactinellida; Hexasterophora; Lyssacinosida; Leucopsacidae; Oopsacas
Ryan2013_est_Convolutriloba_longifissura	 Metazoa; Eumetazoa; Bilateria; Xenacoelomorpha; Acoelomorpha; Acoela; Sagittiferidae; Convolutriloba
Ryan2013_est_Mertensiid_sp	 Metazoa; Eumetazoa; Ctenophora; Tentaculata; Cydippida; Mertensiidae; unclassified Mertensiidae
Ryan2013_est_Paraplanocera_oligoglena	 Metazoa; Eumetazoa; Bilateria; Platyhelminthes; Rhabditophora; Polycladida; Acotylea; Stylochoidea; Planoceridae; Paraplanocera
Ryan2013_est_Nemertoderma_westbladi	 Metazoa; Eumetazoa; Bilateria; Xenacoelomorpha; Acoelomorpha; Nemertodermatida; Nemertodermatidae; Nemertoderma
Ryan2013_est_Echinoderes_horni	 Metazoa; Eumetazoa; Bilateria; Protostomia; Ecdysozoa; Scalidophora; Kinorhyncha; Cyclorhagida; Echinoderidae; Echinoderes
Ryan2013_est_Ptychodera_flava	 Metazoa; Eumetazoa; Bilateria; Deuterostomia; Hemichordata; Enteropneusta; Ptychoderidae; Ptychodera
Ryan2013_est_Sphaeroforma_arctica	 Opisthokonta incertae sedis; Ichthyosporea; Ichthyophonida; Sphaeroforma
Ryan2013_est_Rhizopus_oryzae	 Fungi; Fungi incertae sedis; Mucoromycota; Mucoromycotina; Mucoromycetes; Mucorales; Mucorineae; Rhizopodaceae; Rhizopus
Ryan2013_est_Podocoryna_carnea	 Metazoa; Eumetazoa; Cnidaria; Hydrozoa; Hydroidolina; Anthoathecata; Filifera; Hydractiniidae; Podocoryna
Ryan2013_est_Amoebidium_parasiticum	 Opisthokonta incertae sedis; Ichthyosporea; Ichthyophonida; Amoebidiaceae; Amoebidium
Ryan2013_est_Sycon_raphanus	 Metazoa; Porifera; Calcarea; Calcaronea; Leucosolenida; Sycettidae; Sycon
Ryan2013_est_Xenoturbella_bocki	 Metazoa; Eumetazoa; Bilateria; Xenacoelomorpha; Xenoturbellida; Xenoturbellidae; Xenoturbella
Ryan2013_est_Carteriospongia_foliascens	 Metazoa; Porifera; Demospongiae; Keratosa; Dictyoceratida; Thorectidae; Carteriospongia
Ryan2013_est_Aiptasia_pallida	 Metazoa; Eumetazoa; Cnidaria; Anthozoa; Hexacorallia; Actiniaria; Aiptasiidae; Exaiptasia
Ryan2013_est_Leucetta_chagosensis	 Metazoa; Porifera; Calcarea; Calcinea; Clathrinida; Leucettidae; Leucetta
Simion2017_Abeoforma_whisleri	 Opisthokonta incertae sedis; Ichthyosporea; Abeoforma
Simion2017_Acanthoeca_sp	 Choanoflagellida; Acanthoecida; Acanthoecidae
Simion2017_Acanthoeca_spectabilis	 Choanoflagellida; Acanthoecida; Acanthoecidae; Acanthoeca
Simion2017_Aiptasia_pallida	 Metazoa; Eumetazoa; Cnidaria; Anthozoa; Hexacorallia; Actiniaria; Aiptasiidae; Exaiptasia
Simion2017_Alatina_alata	 Metazoa; Eumetazoa; Cnidaria; Cubozoa; Carybdeida; Alatinidae; Alatina
Simion2017_Amoebidium_parasiticum	 Opisthokonta incertae sedis; Ichthyosporea; Ichthyophonida; Amoebidiaceae; Amoebidium
Simion2017_Amphimedon_queenslandica	 Metazoa; Porifera; Demospongiae; Heteroscleromorpha; Haplosclerida; Niphatidae; Amphimedon
Simion2017_Antipathes_caribbeana	 Metazoa; Eumetazoa; Cnidaria; Anthozoa; Hexacorallia; Antipatharia; Antipathidae; Antipathes
Simion2017_Aphrocallistes_vastus	 Metazoa; Porifera; Hexactinellida; Hexasterophora; Hexactinosida; Sceptrulophora; Aphrocallistidae; Aphrocallistes
Simion2017_Aplysia_californica	 Metazoa; Eumetazoa; Bilateria; Protostomia; Lophotrochozoa; Mollusca; Gastropoda; Heterobranchia; Euthyneura; Euopisthobranchia; Aplysiida; Aplysioidea; Aplysiidae; Aplysia
Simion2017_Atolla_vanhoeffeni	 Metazoa; Eumetazoa; Cnidaria; Scyphozoa; Coronatae; Atollidae; Atolla
Simion2017_Aurelia_aurita	 Metazoa; Eumetazoa; Cnidaria; Scyphozoa; Semaeostomeae; Ulmaridae; Aurelia
Simion2017_Beroe_abyssicola	 Metazoa; Eumetazoa; Ctenophora; Nuda; Beroida; Beroidae; Beroe
Simion2017_Beroe_sp	 Metazoa; Eumetazoa; Ctenophora; Nuda; Beroida; Beroidae
Simion2017_Bolinopsis_infundibulum	 Metazoa; Eumetazoa; Ctenophora; Tentaculata; Lobata; Bolinopsidae; Bolinopsis
Simion2017_Bolocera_tuediae	 Metazoa; Eumetazoa; Cnidaria; Anthozoa; Hexacorallia; Actiniaria; Actiniidae; Bolocera
Simion2017_Branchiostoma_floridae	 Metazoa; Eumetazoa; Bilateria; Deuterostomia; Chordata; Cephalochordata; Branchiostomidae; Branchiostoma
Simion2017_Capitella_teleta	 Metazoa; Eumetazoa; Bilateria; Protostomia; Lophotrochozoa; Annelida; Polychaeta; Scolecida; Capitellida; Capitellidae; Capitella
Simion2017_Capsaspora_owczarzaki	 Opisthokonta incertae sedis; Ichthyosporea; Capsaspora
Simion2017_Cestum_veneris	 Metazoa; Eumetazoa; Ctenophora; Tentaculata; Cestida; Cestidae; Cestum
Simion2017_Choanoeca_perplexa_11	 Choanoflagellida; Craspedida; Salpingoecidae; Choanoeca
Simion2017_Chondrilla_nucula	 Metazoa; Porifera; Demospongiae; Verongimorpha; Chondrillida; Chondrillidae; Chondrilla
Simion2017_Clathrina_coriacea	 Metazoa; Porifera; Calcarea; Calcinea; Clathrinida; Clathrinidae; Clathrina
Simion2017_Clytia_hemisphaerica	 Metazoa; Eumetazoa; Cnidaria; Hydrozoa; Hydroidolina; Leptothecata; Campanulariidae; Clytia
Simion2017_Codosiga_hollandica_17	 Choanoflagellida; Craspedida; Salpingoecidae; Codosiga
Simion2017_Coeloplana_species	 Metazoa; Eumetazoa; Ctenophora; Tentaculata; Platyctenida; Coeloplanidae
Simion2017_Corticium_candelabrum	 Metazoa; Porifera; Homoscleromorpha; Homosclerophorida; Plakinidae; Corticium
Simion2017_Craspedacusta_sowerbii	 Metazoa; Eumetazoa; Cnidaria; Hydrozoa; Trachylinae; Limnomedusae; Olindiidae; Craspedacusta
Simion2017_Crassostrea_gigas	 Metazoa; Eumetazoa; Bilateria; Protostomia; Lophotrochozoa; Mollusca; Bivalvia; Pteriomorphia; Ostreoida; Ostreoidea; Ostreidae; Crassostrea
Simion2017_Creolimax_fragrantissima	 Opisthokonta incertae sedis; Ichthyosporea; Ichthyophonida; Creolimax
Simion2017_Daphnia_pulex	 Metazoa; Eumetazoa; Bilateria; Protostomia; Ecdysozoa; Panarthropoda; Arthropoda; Mandibulata; Pancrustacea; Crustacea; Branchiopoda; Phyllopoda; Diplostraca; Cladocera; Anomopoda; Daphniidae; Daphnia
Simion2017_Diaphanoeca_grandis	 Choanoflagellida; Acanthoecida; Stephanoecidae; Diaphanoeca
Simion2017_Didymoeca_costata_10	 Choanoflagellida; Acanthoecida; Stephanoecidae; Didymoeca
Simion2017_Dryodora_glandiformis	 Metazoa; Eumetazoa; Ctenophora; Tentaculata; Cydippida; Dryodoridae; Dryodora
Simion2017_Edwardsiella_lineata	 Metazoa; Eumetazoa; Cnidaria; Anthozoa; Hexacorallia; Actiniaria; Edwardsiidae; Edwardsiella
Simion2017_Ephydatia_muelleri	 Metazoa; Porifera; Demospongiae; Heteroscleromorpha; Spongillida; Spongillidae; Ephydatia
Simion2017_Euplectella_aspergillum	 Metazoa; Porifera; Hexactinellida; Hexasterophora; Lyssacinosida; Euplectellidae; Euplectella
Simion2017_Euplokamis_dunlapae	 Metazoa; Eumetazoa; Ctenophora; Tentaculata; Cydippida; Euplokamidae; Euplokamis
Simion2017_Gorgonia_ventalina	 Metazoa; Eumetazoa; Cnidaria; Anthozoa; Octocorallia; Alcyonacea; Holaxonia; Gorgoniidae; Gorgonia
Simion2017_Grantia_compressa	 Metazoa; Porifera; Calcarea; Calcaronea; Leucosolenida; Grantiidae; Grantia
Simion2017_Helobdella_robusta	 Metazoa; Eumetazoa; Bilateria; Protostomia; Lophotrochozoa; Annelida; Clitellata; Hirudinea; Hirudinida; Glossiphoniiformes; Glossiphoniidae; Helobdella
Simion2017_Homo_sapiens	 Metazoa; Eumetazoa; Bilateria; Deuterostomia; Chordata; Craniata; Vertebrata; Gnathostomata; Teleostomi; Euteleostomi; Sarcopterygii; Dipnotetrapodomorpha; Tetrapoda; Amniota; Mammalia; Theria; Eutheria; Boreoeutheria; Euarchontoglires; Primates; Haplorrhini; Simiiformes; Catarrhini; Hominoidea; Hominidae; Homininae; Homo
Simion2017_Hormiphora_californensis	 Metazoa; Eumetazoa; Ctenophora; Tentaculata; Cydippida; Pleurobrachiidae; Hormiphora
Simion2017_Hyalonema_populiferum	 Metazoa; Porifera; Hexactinellida; Amphidiscophora; Amphidiscosida; Hyalonematidae; Hyalonema
Simion2017_Hydra_vulgaris_01	 Metazoa; Eumetazoa; Cnidaria; Hydrozoa; Hydroidolina; Anthoathecata; Aplanulata; Hydridae; Hydra
Simion2017_Hydractinia_polyclina	 Metazoa; Eumetazoa; Cnidaria; Hydrozoa; Hydroidolina; Anthoathecata; Filifera; Hydractiniidae; Hydractinia
Simion2017_Ircinia_fasciculata	 Metazoa; Porifera; Demospongiae; Keratosa; Dictyoceratida; Irciniidae; Sarcotragus
Simion2017_Ixodes_scapularis	 Metazoa; Eumetazoa; Bilateria; Protostomia; Ecdysozoa; Panarthropoda; Arthropoda; Chelicerata; Arachnida; Acari; Parasitiformes; Ixodida; Ixodoidea; Ixodidae; Ixodinae; Ixodes
Simion2017_Kirkpatrickia_variolosa	 Metazoa; Porifera; Demospongiae; Heteroscleromorpha; Poecilosclerida; Hymedesmiidae; Kirkpatrickia
Simion2017_Lampea_pancerina	 Metazoa; Eumetazoa; Ctenophora; Tentaculata; Cydippida; Lampeidae; Lampea
Simion2017_Latrunculia_apicalis	 Metazoa; Porifera; Demospongiae; Heteroscleromorpha; Poecilosclerida; Latrunculiidae; Latrunculia
Simion2017_Leuconia_nivea	 Metazoa; Porifera; Calcarea; Calcaronea; Baerida; Baeriidae; Leuconia
Simion2017_Leucosolenia_complicata	 Metazoa; Porifera; Calcarea; Calcaronea; Leucosolenida; Leucosoleniidae; Leucosolenia
Simion2017_Liriope_tetraphylla	 Metazoa; Eumetazoa; Cnidaria; Hydrozoa; Trachylinae; Trachymedusae; Geryoniidae; Liriope
Simion2017_Lucernariopsis_campanulata	 Metazoa; Eumetazoa; Cnidaria; Staurozoa; Stauromedusae; Amyostaurida; Kishinouyeidae; Calvadosia
Simion2017_Ministeria_vibrans	 Opisthokonta incertae sedis; Ministeria
Simion2017_Mnemiopsis_leidyi	 Metazoa; Eumetazoa; Ctenophora; Tentaculata; Lobata; Bolinopsidae; Mnemiopsis
Simion2017_Monosiga_brevicollis	 Choanoflagellida; Craspedida; Salpingoecidae; Monosiga
Simion2017_Orbicella_faveolata	 Metazoa; Eumetazoa; Cnidaria; Anthozoa; Hexacorallia; Scleractinia; Faviina; Merulinidae; Orbicella
Simion2017_Mycale_phyllophila	 Metazoa; Porifera; Demospongiae; Heteroscleromorpha; Poecilosclerida; Mycalidae; Mycale
Simion2017_Mylnosiga_fluctuans_19	 Choanoflagellida; Craspedida; Salpingoecidae; Mylnosiga
Simion2017_Nanomia_bijuga	 Metazoa; Eumetazoa; Cnidaria; Hydrozoa; Hydroidolina; Siphonophorae; Physonectae; Agalmatidae; Nanomia
Simion2017_Nematostella_vectensis	 Metazoa; Eumetazoa; Cnidaria; Anthozoa; Hexacorallia; Actiniaria; Edwardsiidae; Nematostella
Simion2017_Oscarella_carmela	 Metazoa; Porifera; Homoscleromorpha; Homosclerophorida; Plakinidae; Oscarella
Simion2017_Oscarella_species	 Metazoa; Porifera; Homoscleromorpha; Homosclerophorida; Plakinidae
Simion2017_Pelagia_noctiluca	 Metazoa; Eumetazoa; Cnidaria; Scyphozoa; Semaeostomeae; Pelagiidae; Pelagia
Simion2017_Pennatula_rubra	 Metazoa; Eumetazoa; Cnidaria; Anthozoa; Octocorallia; Pennatulacea; Subselliflorae; Pennatulidae; Pennatula
Simion2017_Periphylla_periphylla	 Metazoa; Eumetazoa; Cnidaria; Scyphozoa; Coronatae; Periphyllidae; Periphylla
Simion2017_Petrosia_ficiformis	 Metazoa; Porifera; Demospongiae; Heteroscleromorpha; Haplosclerida; Petrosiidae; Petrosia
Simion2017_Pirum_gemmata	 Opisthokonta incertae sedis; Ichthyosporea; Pirum
Simion2017_Plakina_jani	 Metazoa; Porifera; Homoscleromorpha; Homosclerophorida; Plakinidae; Plakina
Simion2017_Pleraplysilla_spinifera	 Metazoa; Porifera; Demospongiae; Keratosa; Dendroceratida; Darwinellidae; Pleraplysilla
Simion2017_Pleurobrachia_species	 Metazoa; Eumetazoa; Ctenophora; Tentaculata; Cydippida; Pleurobrachiidae
Simion2017_Plumapathes_pennacea	 Metazoa; Eumetazoa; Cnidaria; Anthozoa; Hexacorallia; Antipatharia; Myriopathidae; Plumapathes
Simion2017_Porites_australiensis	 Metazoa; Eumetazoa; Cnidaria; Anthozoa; Hexacorallia; Scleractinia; Fungiina; Poritidae; Porites
Simion2017_Rossella_fibulata	 Metazoa; Porifera; Hexactinellida; Hexasterophora; Lyssacinosida; Rossellidae; Rossella
Simion2017_Saccoglossus_kowalevskii	 Metazoa; Eumetazoa; Bilateria; Deuterostomia; Hemichordata; Enteropneusta; Harrimaniidae; Saccoglossus
Simion2017_Salpingoeca_dolichothecata_16	 Choanoflagellida; Craspedida; Salpingoecidae; Salpingoeca
Simion2017_Salpingoeca_helianthica_18	 Choanoflagellida; Craspedida; Salpingoecidae; Salpingoeca
Simion2017_Salpingoeca_infusionum_12	 Choanoflagellida; Craspedida; Salpingoecidae; Salpingoeca
Simion2017_Salpingoeca_macrocollata_06	 Choanoflagellida; Craspedida; Salpingoecidae; Salpingoeca
Simion2017_Salpingoeca_punica_03	 Choanoflagellida; Craspedida; Salpingoecidae; Salpingoeca
Simion2017_Salpingoeca_kvevrii	 Choanoflagellida; Craspedida; Salpingoecidae; Salpingoeca
Simion2017_Microstomoeca_roanoka	 Choanoflagellida; Craspedida; Salpingoecidae; Microstomoeca
Simion2017_Salpingoeca_rosetta	 Choanoflagellida; Craspedida; Salpingoecidae; Salpingoeca
Simion2017_Salpingoeca_urceolata_04	 Choanoflagellida; Craspedida; Salpingoecidae; Salpingoeca
Simion2017_Sphaeroforma_arctica	 Opisthokonta incertae sedis; Ichthyosporea; Ichthyophonida; Sphaeroforma
Simion2017_Spongilla_lacustris	 Metazoa; Porifera; Demospongiae; Heteroscleromorpha; Spongillida; Spongillidae; Spongilla
Simion2017_Stephanoeca_diplocostata	 Choanoflagellida; Acanthoecida; Stephanoecidae; Stephanoeca
Simion2017_Stomolophus_meleagris	 Metazoa; Eumetazoa; Cnidaria; Scyphozoa; Rhizostomeae; Rhizostomatidae; Stomolophus
Simion2017_Strongylocentrotus_purpuratus	 Metazoa; Eumetazoa; Bilateria; Deuterostomia; Echinodermata; Eleutherozoa; Echinozoa; Echinoidea; Euechinoidea; Echinacea; Echinoida; Strongylocentrotidae; Strongylocentrotus
Simion2017_Sycon_ciliatum	 Metazoa; Porifera; Calcarea; Calcaronea; Leucosolenida; Sycettidae; Sycon
Simion2017_Sycon_coactum	 Metazoa; Porifera; Calcarea; Calcaronea; Leucosolenida; Sycettidae; Sycon
Simion2017_Sympagella_nux	 Metazoa; Porifera; Hexactinellida; Hexasterophora; Lyssacinosida; Rossellidae; Sympagella
Simion2017_Tribolium_castaneum	 Metazoa; Eumetazoa; Bilateria; Protostomia; Ecdysozoa; Panarthropoda; Arthropoda; Mandibulata; Pancrustacea; Hexapoda; Insecta; Dicondylia; Pterygota; Neoptera; Holometabola; Coleoptera; Polyphaga; Cucujiformia; Tenebrionoidea; Tenebrionidae; Tenebrionidae incertae sedis; Tribolium
Simion2017_Trichoplax_adhaerens	 Metazoa; Placozoa; Trichoplacidae; Trichoplax
Simion2017_Vallicula_multiformis	 Metazoa; Eumetazoa; Ctenophora; Tentaculata; Platyctenida; Coeloplanidae; Vallicula
Whelan2015_D1_Aurelia_aurita	 Metazoa; Eumetazoa; Cnidaria; Scyphozoa; Semaeostomeae; Ulmaridae; Aurelia
Whelan2015_D1_Lottia_gigantea	 Metazoa; Eumetazoa; Bilateria; Protostomia; Lophotrochozoa; Mollusca; Gastropoda; Patellogastropoda; Lottioidea; Lottiidae; Lottia
Whelan2015_D1_Acanthoeca_spectabilis	 Choanoflagellida; Acanthoecida; Acanthoecidae; Acanthoeca
Whelan2015_D1_Sphaeroforma_arctica	 Opisthokonta incertae sedis; Ichthyosporea; Ichthyophonida; Sphaeroforma
Whelan2015_D1_Aspergillus_fumigatus	 Fungi; Dikarya; Ascomycota; saccharomyceta; Pezizomycotina; leotiomyceta; Eurotiomycetes; Eurotiomycetidae; Eurotiales; Aspergillaceae; Aspergillus
Whelan2015_D1_Bolocera_tuediae	 Metazoa; Eumetazoa; Cnidaria; Anthozoa; Hexacorallia; Actiniaria; Actiniidae; Bolocera
Whelan2015_D1_Drosophila_melanogaster	 Metazoa; Eumetazoa; Bilateria; Protostomia; Ecdysozoa; Panarthropoda; Arthropoda; Mandibulata; Pancrustacea; Hexapoda; Insecta; Dicondylia; Pterygota; Neoptera; Holometabola; Diptera; Brachycera; Muscomorpha; Eremoneura; Cyclorrhapha; Schizophora; Acalyptratae; Ephydroidea; Drosophilidae; Drosophilinae; Drosophilini; Drosophila; Sophophora; melanogaster group; melanogaster subgroup
Whelan2015_D1_Rossella_fibulata	 Metazoa; Porifera; Hexactinellida; Hexasterophora; Lyssacinosida; Rossellidae; Rossella
Whelan2015_D1_Tubulanus_polymorphus	 Metazoa; Eumetazoa; Bilateria; Protostomia; Lophotrochozoa; Nemertea; Palaeonemertea; Tubulanidae; Tubulanus
Whelan2015_D1_Amoebidium_parasiticum	 Opisthokonta incertae sedis; Ichthyosporea; Ichthyophonida; Amoebidiaceae; Amoebidium
Whelan2015_D1_Abylopsis_tetragona	 Metazoa; Eumetazoa; Cnidaria; Hydrozoa; Hydroidolina; Siphonophorae; Calycophorae; Abylidae; Abylopsis
Whelan2015_D1_Eunicella_verrucosa	 Metazoa; Eumetazoa; Cnidaria; Anthozoa; Octocorallia; Alcyonacea; Holaxonia; Gorgoniidae; Eunicella
Whelan2015_D1_Dryodora_glandiformis	 Metazoa; Eumetazoa; Ctenophora; Tentaculata; Cydippida; Dryodoridae; Dryodora
Whelan2015_D1_Euplokamis_dunlapae	 Metazoa; Eumetazoa; Ctenophora; Tentaculata; Cydippida; Euplokamidae; Euplokamis
Whelan2015_D1_Lithobius_forficatus	 Metazoa; Eumetazoa; Bilateria; Protostomia; Ecdysozoa; Panarthropoda; Arthropoda; Mandibulata; Myriapoda; Chilopoda; Pleurostigmophora; Lithobiomorpha; Lithobiidae; Lithobius
Whelan2015_D1_Daphnia_pulex	 Metazoa; Eumetazoa; Bilateria; Protostomia; Ecdysozoa; Panarthropoda; Arthropoda; Mandibulata; Pancrustacea; Crustacea; Branchiopoda; Phyllopoda; Diplostraca; Cladocera; Anomopoda; Daphniidae; Daphnia
Whelan2015_D1_Pleurobrachia_pileus	 Metazoa; Eumetazoa; Ctenophora; Tentaculata; Cydippida; Pleurobrachiidae; Pleurobrachia
Whelan2015_D1_Neurospora_crassa	 Fungi; Dikarya; Ascomycota; saccharomyceta; Pezizomycotina; leotiomyceta; sordariomyceta; Sordariomycetes; Sordariomycetidae; Sordariales; Sordariaceae; Neurospora
Whelan2015_D1_Aiptasia_pallida	 Metazoa; Eumetazoa; Cnidaria; Anthozoa; Hexacorallia; Actiniaria; Aiptasiidae; Exaiptasia
Whelan2015_D1_Mortierella_verticillata	 Fungi; Fungi incertae sedis; Mucoromycota; Mortierellomycotina; Mortierellomycetes; Mortierellales; Mortierellaceae; Mortierella
Whelan2015_D1_Homo_sapiens	 Metazoa; Eumetazoa; Bilateria; Deuterostomia; Chordata; Craniata; Vertebrata; Gnathostomata; Teleostomi; Euteleostomi; Sarcopterygii; Dipnotetrapodomorpha; Tetrapoda; Amniota; Mammalia; Theria; Eutheria; Boreoeutheria; Euarchontoglires; Primates; Haplorrhini; Simiiformes; Catarrhini; Hominoidea; Hominidae; Homininae; Homo
Whelan2015_D1_Amphimedon_queenslandica	 Metazoa; Porifera; Demospongiae; Heteroscleromorpha; Haplosclerida; Niphatidae; Amphimedon
Whelan2015_D1_Petrosia_ficiformis	 Metazoa; Porifera; Demospongiae; Heteroscleromorpha; Haplosclerida; Petrosiidae; Petrosia
Whelan2015_D1_Strongylocentrotus_purpuratus	 Metazoa; Eumetazoa; Bilateria; Deuterostomia; Echinodermata; Eleutherozoa; Echinozoa; Echinoidea; Euechinoidea; Echinacea; Echinoida; Strongylocentrotidae; Strongylocentrotus
Whelan2015_D1_Physalia_physalis	 Metazoa; Eumetazoa; Cnidaria; Hydrozoa; Hydroidolina; Siphonophorae; Cystonectae; Physaliidae; Physalia
Whelan2015_D1_Hydra_vulgaris	 Metazoa; Eumetazoa; Cnidaria; Hydrozoa; Hydroidolina; Anthoathecata; Aplanulata; Hydridae; Hydra
Whelan2015_D1_Corticium_candelabrum	 Metazoa; Porifera; Homoscleromorpha; Homosclerophorida; Plakinidae; Corticium
Whelan2015_D1_Nanomia_bijuga	 Metazoa; Eumetazoa; Cnidaria; Hydrozoa; Hydroidolina; Siphonophorae; Physonectae; Agalmatidae; Nanomia
Whelan2015_D1_Sympagella_nux	 Metazoa; Porifera; Hexactinellida; Hexasterophora; Lyssacinosida; Rossellidae; Sympagella
Whelan2015_D1_Spongilla_lacustris	 Metazoa; Porifera; Demospongiae; Heteroscleromorpha; Spongillida; Spongillidae; Spongilla
Whelan2015_D1_Monosiga_ovata	 Choanoflagellida; Craspedida; Salpingoecidae; Monosiga
Whelan2015_D1_Crella_elegans	 Metazoa; Porifera; Demospongiae; Heteroscleromorpha; Poecilosclerida; Crellidae; Crella
Whelan2015_D1_Ministeria_vibrans	 Opisthokonta incertae sedis; Ministeria
Whelan2015_D1_Mnemiopsis_leidyi	 Metazoa; Eumetazoa; Ctenophora; Tentaculata; Lobata; Bolinopsidae; Mnemiopsis
Whelan2015_D1_Petromyzon_marinus	 Metazoa; Eumetazoa; Bilateria; Deuterostomia; Chordata; Craniata; Vertebrata; Cyclostomata; Hyperoartia; Petromyzontiformes; Petromyzontidae; Petromyzon
Whelan2015_D1_Allomyces_macrogynus	 Fungi; Fungi incertae sedis; Blastocladiomycota; Blastocladiomycetes; Blastocladiales; Blastocladiaceae; Allomyces
Whelan2015_D1_Hemithiris_psittacea	 Metazoa; Eumetazoa; Bilateria; Protostomia; Lophotrochozoa; Brachiopoda; Rhynchonelliformea; Rhynchonellata; Rhynchonellida; Hemithiridoidea; Hemithyrididae; Hemithiris
Whelan2015_D1_Agalma_elegans	 Metazoa; Eumetazoa; Cnidaria; Hydrozoa; Hydroidolina; Siphonophorae; Physonectae; Agalmatidae; Agalma
Whelan2015_D1_Tethya_wilhelma	 Metazoa; Porifera; Demospongiae; Heteroscleromorpha; Tethyida; Tethyidae; Tethya
Whelan2015_D1_Bolinopsis_infundibulum	 Metazoa; Eumetazoa; Ctenophora; Tentaculata; Lobata; Bolinopsidae; Bolinopsis
Whelan2015_D1_Ephydatia_muelleri	 Metazoa; Porifera; Demospongiae; Heteroscleromorpha; Spongillida; Spongillidae; Ephydatia
Whelan2015_D1_Capitella_teleta	 Metazoa; Eumetazoa; Bilateria; Protostomia; Lophotrochozoa; Annelida; Polychaeta; Scolecida; Capitellida; Capitellidae; Capitella
Whelan2015_D1_Platygyra_carnosa	 Metazoa; Eumetazoa; Cnidaria; Anthozoa; Hexacorallia; Scleractinia; Faviina; Merulinidae; Platygyra
Whelan2015_D1_Salpingoeca_pyxidium	 Choanoflagellida; Craspedida; Salpingoecidae; Salpingoeca
Whelan2015_D1_Salpingoeca_rosetta	 Choanoflagellida; Craspedida; Salpingoecidae; Salpingoeca
Whelan2015_D1_Chondrilla_nucula	 Metazoa; Porifera; Demospongiae; Verongimorpha; Chondrillida; Chondrillidae; Chondrilla
Whelan2015_D1_Trichoplax_adhaerens	 Metazoa; Placozoa; Trichoplacidae; Trichoplax
Whelan2015_D1_Pleurobrachia_bachei	 Metazoa; Eumetazoa; Ctenophora; Tentaculata; Cydippida; Pleurobrachiidae; Pleurobrachia
Whelan2015_D1_Monosiga_brevicollis	 Choanoflagellida; Craspedida; Salpingoecidae; Monosiga
Whelan2015_D1_Beroe_abyssicola	 Metazoa; Eumetazoa; Ctenophora; Nuda; Beroida; Beroidae; Beroe
Whelan2015_D1_Hydra_viridissima	 Metazoa; Eumetazoa; Cnidaria; Hydrozoa; Hydroidolina; Anthoathecata; Aplanulata; Hydridae; Hydra
Whelan2015_D1_Acropora_digitifera	 Metazoa; Eumetazoa; Cnidaria; Anthozoa; Hexacorallia; Scleractinia; Astrocoeniina; Acroporidae; Acropora
Whelan2015_D1_Kirkpatrickia_variolosa	 Metazoa; Porifera; Demospongiae; Heteroscleromorpha; Poecilosclerida; Hymedesmiidae; Kirkpatrickia
Whelan2015_D1_Latrunculia_apicalis	 Metazoa; Porifera; Demospongiae; Heteroscleromorpha; Poecilosclerida; Latrunculiidae; Latrunculia
Whelan2015_D1_Hyalonema_populiferum	 Metazoa; Porifera; Hexactinellida; Amphidiscophora; Amphidiscosida; Hyalonematidae; Hyalonema
Whelan2015_D1_Rhizopus_oryzae	 Fungi; Fungi incertae sedis; Mucoromycota; Mucoromycotina; Mucoromycetes; Mucorales; Mucorineae; Rhizopodaceae; Rhizopus
Whelan2015_D1_Coeloplana_astericola	 Metazoa; Eumetazoa; Ctenophora; Tentaculata; Platyctenida; Coeloplanidae; Coeloplana
Whelan2015_D1_Periphylla_periphylla	 Metazoa; Eumetazoa; Cnidaria; Scyphozoa; Coronatae; Periphyllidae; Periphylla
Whelan2015_D1_Vallicula_sp	 Metazoa; Eumetazoa; Ctenophora; Tentaculata; Platyctenida; Coeloplanidae
Whelan2015_D1_Hormathia_digitata	 Metazoa; Eumetazoa; Cnidaria; Anthozoa; Hexacorallia; Actiniaria; Nynantheae; Hormathiidae; Hormathia
Whelan2015_D1_Hydra_oligactis	 Metazoa; Eumetazoa; Cnidaria; Hydrozoa; Hydroidolina; Anthoathecata; Aplanulata; Hydridae; Hydra
Whelan2015_D1_Mertensiidae_sp	 Metazoa; Eumetazoa; Ctenophora; Tentaculata; Cydippida; Mertensiidae; unclassified Mertensiidae
Whelan2015_D1_Pseudospongosorites_suberitoides	 Metazoa; Porifera; Demospongiae; Heteroscleromorpha; Suberitida; Suberitidae; Pseudospongosorites
Whelan2015_D1_Sycon_ciliatum	 Metazoa; Porifera; Calcarea; Calcaronea; Leucosolenida; Sycettidae; Sycon
Whelan2015_D1_Sycon_coactum	 Metazoa; Porifera; Calcarea; Calcaronea; Leucosolenida; Sycettidae; Sycon
Whelan2015_D1_Ircinia_fasciculata	 Metazoa; Porifera; Demospongiae; Keratosa; Dictyoceratida; Irciniidae; Sarcotragus
Whelan2015_D1_Saccharomyces_cerevisiae	 Fungi; Dikarya; Ascomycota; saccharomyceta; Saccharomycotina; Saccharomycetes; Saccharomycetales; Saccharomycetaceae; Saccharomyces
Whelan2015_D1_Spizellomyces_punctatus	 Fungi; Fungi incertae sedis; Chytridiomycota; Chytridiomycetes; Spizellomycetales; Spizellomycetaceae; Spizellomyces
Whelan2015_D1_Capsaspora_owczarzaki	 Opisthokonta incertae sedis; Ichthyosporea; Capsaspora
Whelan2015_D1_Aphrocallistes_vastus	 Metazoa; Porifera; Hexactinellida; Hexasterophora; Hexactinosida; Sceptrulophora; Aphrocallistidae; Aphrocallistes
Whelan2015_D1_Oscarella_carmela	 Metazoa; Porifera; Homoscleromorpha; Homosclerophorida; Plakinidae; Oscarella
Whelan2015_D1_Danio_rerio	 Metazoa; Eumetazoa; Bilateria; Deuterostomia; Chordata; Craniata; Vertebrata; Gnathostomata; Teleostomi; Euteleostomi; Actinopterygii; Actinopteri; Neopterygii; Teleostei; Osteoglossocephalai; Clupeocephala; Otomorpha; Ostariophysi; Otophysi; Cypriniphysae; Cypriniformes; Cyprinoidea; Cyprinidae; Danio
Whelan2015_D1_Craseoa_lathetica	 Metazoa; Eumetazoa; Cnidaria; Hydrozoa; Hydroidolina; Siphonophorae; Calycophorae; Prayidae; Prayinae; Craseoa
Whelan2015_D1_Nematostella_vectensis	 Metazoa; Eumetazoa; Cnidaria; Anthozoa; Hexacorallia; Actiniaria; Edwardsiidae; Nematostella
Whelan2015_D1_Saccoglossus_kowalevskii	 Metazoa; Eumetazoa; Bilateria; Deuterostomia; Hemichordata; Enteropneusta; Harrimaniidae; Saccoglossus
Whelan2015_D1_Priapulus_caudatus	 Metazoa; Eumetazoa; Bilateria; Protostomia; Ecdysozoa; Scalidophora; Priapulida; Priapulimorpha; Priapulimorphida; Priapulidae; Priapulus
Whelan2015_D10_Aurelia_aurita	 Metazoa; Eumetazoa; Cnidaria; Scyphozoa; Semaeostomeae; Ulmaridae; Aurelia
Whelan2015_D10_Lottia_gigantea	 Metazoa; Eumetazoa; Bilateria; Protostomia; Lophotrochozoa; Mollusca; Gastropoda; Patellogastropoda; Lottioidea; Lottiidae; Lottia
Whelan2015_D10_Sphaeroforma_arctica	 Opisthokonta incertae sedis; Ichthyosporea; Ichthyophonida; Sphaeroforma
Whelan2015_D10_Bolocera_tuediae	 Metazoa; Eumetazoa; Cnidaria; Anthozoa; Hexacorallia; Actiniaria; Actiniidae; Bolocera
Whelan2015_D10_Drosophila_melanogaster	 Metazoa; Eumetazoa; Bilateria; Protostomia; Ecdysozoa; Panarthropoda; Arthropoda; Mandibulata; Pancrustacea; Hexapoda; Insecta; Dicondylia; Pterygota; Neoptera; Holometabola; Diptera; Brachycera; Muscomorpha; Eremoneura; Cyclorrhapha; Schizophora; Acalyptratae; Ephydroidea; Drosophilidae; Drosophilinae; Drosophilini; Drosophila; Sophophora; melanogaster group; melanogaster subgroup
Whelan2015_D10_Rossella_fibulata	 Metazoa; Porifera; Hexactinellida; Hexasterophora; Lyssacinosida; Rossellidae; Rossella
Whelan2015_D10_Tubulanus_polymorphus	 Metazoa; Eumetazoa; Bilateria; Protostomia; Lophotrochozoa; Nemertea; Palaeonemertea; Tubulanidae; Tubulanus
Whelan2015_D10_Amoebidium_parasiticum	 Opisthokonta incertae sedis; Ichthyosporea; Ichthyophonida; Amoebidiaceae; Amoebidium
Whelan2015_D10_Abylopsis_tetragona	 Metazoa; Eumetazoa; Cnidaria; Hydrozoa; Hydroidolina; Siphonophorae; Calycophorae; Abylidae; Abylopsis
Whelan2015_D10_Eunicella_verrucosa	 Metazoa; Eumetazoa; Cnidaria; Anthozoa; Octocorallia; Alcyonacea; Holaxonia; Gorgoniidae; Eunicella
Whelan2015_D10_Dryodora_glandiformis	 Metazoa; Eumetazoa; Ctenophora; Tentaculata; Cydippida; Dryodoridae; Dryodora
Whelan2015_D10_Euplokamis_dunlapae	 Metazoa; Eumetazoa; Ctenophora; Tentaculata; Cydippida; Euplokamidae; Euplokamis
Whelan2015_D10_Lithobius_forficatus	 Metazoa; Eumetazoa; Bilateria; Protostomia; Ecdysozoa; Panarthropoda; Arthropoda; Mandibulata; Myriapoda; Chilopoda; Pleurostigmophora; Lithobiomorpha; Lithobiidae; Lithobius
Whelan2015_D10_Daphnia_pulex	 Metazoa; Eumetazoa; Bilateria; Protostomia; Ecdysozoa; Panarthropoda; Arthropoda; Mandibulata; Pancrustacea; Crustacea; Branchiopoda; Phyllopoda; Diplostraca; Cladocera; Anomopoda; Daphniidae; Daphnia
Whelan2015_D10_Pleurobrachia_pileus	 Metazoa; Eumetazoa; Ctenophora; Tentaculata; Cydippida; Pleurobrachiidae; Pleurobrachia
Whelan2015_D10_Aiptasia_pallida	 Metazoa; Eumetazoa; Cnidaria; Anthozoa; Hexacorallia; Actiniaria; Aiptasiidae; Exaiptasia
Whelan2015_D10_Mortierella_verticillata	 Fungi; Fungi incertae sedis; Mucoromycota; Mortierellomycotina; Mortierellomycetes; Mortierellales; Mortierellaceae; Mortierella
Whelan2015_D10_Homo_sapiens	 Metazoa; Eumetazoa; Bilateria; Deuterostomia; Chordata; Craniata; Vertebrata; Gnathostomata; Teleostomi; Euteleostomi; Sarcopterygii; Dipnotetrapodomorpha; Tetrapoda; Amniota; Mammalia; Theria; Eutheria; Boreoeutheria; Euarchontoglires; Primates; Haplorrhini; Simiiformes; Catarrhini; Hominoidea; Hominidae; Homininae; Homo
Whelan2015_D10_Amphimedon_queenslandica	 Metazoa; Porifera; Demospongiae; Heteroscleromorpha; Haplosclerida; Niphatidae; Amphimedon
Whelan2015_D10_Petrosia_ficiformis	 Metazoa; Porifera; Demospongiae; Heteroscleromorpha; Haplosclerida; Petrosiidae; Petrosia
Whelan2015_D10_Strongylocentrotus_purpuratus	 Metazoa; Eumetazoa; Bilateria; Deuterostomia; Echinodermata; Eleutherozoa; Echinozoa; Echinoidea; Euechinoidea; Echinacea; Echinoida; Strongylocentrotidae; Strongylocentrotus
Whelan2015_D10_Physalia_physalis	 Metazoa; Eumetazoa; Cnidaria; Hydrozoa; Hydroidolina; Siphonophorae; Cystonectae; Physaliidae; Physalia
Whelan2015_D10_Hydra_vulgaris	 Metazoa; Eumetazoa; Cnidaria; Hydrozoa; Hydroidolina; Anthoathecata; Aplanulata; Hydridae; Hydra
Whelan2015_D10_Corticium_candelabrum	 Metazoa; Porifera; Homoscleromorpha; Homosclerophorida; Plakinidae; Corticium
Whelan2015_D10_Nanomia_bijuga	 Metazoa; Eumetazoa; Cnidaria; Hydrozoa; Hydroidolina; Siphonophorae; Physonectae; Agalmatidae; Nanomia
Whelan2015_D10_Sympagella_nux	 Metazoa; Porifera; Hexactinellida; Hexasterophora; Lyssacinosida; Rossellidae; Sympagella
Whelan2015_D10_Spongilla_lacustris	 Metazoa; Porifera; Demospongiae; Heteroscleromorpha; Spongillida; Spongillidae; Spongilla
Whelan2015_D10_Monosiga_ovata	 Choanoflagellida; Craspedida; Salpingoecidae; Monosiga
Whelan2015_D10_Crella_elegans	 Metazoa; Porifera; Demospongiae; Heteroscleromorpha; Poecilosclerida; Crellidae; Crella
Whelan2015_D10_Ministeria_vibrans	 Opisthokonta incertae sedis; Ministeria
Whelan2015_D10_Mnemiopsis_leidyi	 Metazoa; Eumetazoa; Ctenophora; Tentaculata; Lobata; Bolinopsidae; Mnemiopsis
Whelan2015_D10_Petromyzon_marinus	 Metazoa; Eumetazoa; Bilateria; Deuterostomia; Chordata; Craniata; Vertebrata; Cyclostomata; Hyperoartia; Petromyzontiformes; Petromyzontidae; Petromyzon
Whelan2015_D10_Allomyces_macrogynus	 Fungi; Fungi incertae sedis; Blastocladiomycota; Blastocladiomycetes; Blastocladiales; Blastocladiaceae; Allomyces
Whelan2015_D10_Hemithiris_psittacea	 Metazoa; Eumetazoa; Bilateria; Protostomia; Lophotrochozoa; Brachiopoda; Rhynchonelliformea; Rhynchonellata; Rhynchonellida; Hemithiridoidea; Hemithyrididae; Hemithiris
Whelan2015_D10_Agalma_elegans	 Metazoa; Eumetazoa; Cnidaria; Hydrozoa; Hydroidolina; Siphonophorae; Physonectae; Agalmatidae; Agalma
Whelan2015_D10_Tethya_wilhelma	 Metazoa; Porifera; Demospongiae; Heteroscleromorpha; Tethyida; Tethyidae; Tethya
Whelan2015_D10_Bolinopsis_infundibulum	 Metazoa; Eumetazoa; Ctenophora; Tentaculata; Lobata; Bolinopsidae; Bolinopsis
Whelan2015_D10_Ephydatia_muelleri	 Metazoa; Porifera; Demospongiae; Heteroscleromorpha; Spongillida; Spongillidae; Ephydatia
Whelan2015_D10_Capitella_teleta	 Metazoa; Eumetazoa; Bilateria; Protostomia; Lophotrochozoa; Annelida; Polychaeta; Scolecida; Capitellida; Capitellidae; Capitella
Whelan2015_D10_Platygyra_carnosa	 Metazoa; Eumetazoa; Cnidaria; Anthozoa; Hexacorallia; Scleractinia; Faviina; Merulinidae; Platygyra
Whelan2015_D10_Salpingoeca_rosetta	 Choanoflagellida; Craspedida; Salpingoecidae; Salpingoeca
Whelan2015_D10_Chondrilla_nucula	 Metazoa; Porifera; Demospongiae; Verongimorpha; Chondrillida; Chondrillidae; Chondrilla
Whelan2015_D10_Trichoplax_adhaerens	 Metazoa; Placozoa; Trichoplacidae; Trichoplax
Whelan2015_D10_Pleurobrachia_bachei	 Metazoa; Eumetazoa; Ctenophora; Tentaculata; Cydippida; Pleurobrachiidae; Pleurobrachia
Whelan2015_D10_Beroe_abyssicola	 Metazoa; Eumetazoa; Ctenophora; Nuda; Beroida; Beroidae; Beroe
Whelan2015_D10_Hydra_viridissima	 Metazoa; Eumetazoa; Cnidaria; Hydrozoa; Hydroidolina; Anthoathecata; Aplanulata; Hydridae; Hydra
Whelan2015_D10_Acropora_digitifera	 Metazoa; Eumetazoa; Cnidaria; Anthozoa; Hexacorallia; Scleractinia; Astrocoeniina; Acroporidae; Acropora
Whelan2015_D10_Kirkpatrickia_variolosa	 Metazoa; Porifera; Demospongiae; Heteroscleromorpha; Poecilosclerida; Hymedesmiidae; Kirkpatrickia
Whelan2015_D10_Latrunculia_apicalis	 Metazoa; Porifera; Demospongiae; Heteroscleromorpha; Poecilosclerida; Latrunculiidae; Latrunculia
Whelan2015_D10_Hyalonema_populiferum	 Metazoa; Porifera; Hexactinellida; Amphidiscophora; Amphidiscosida; Hyalonematidae; Hyalonema
Whelan2015_D10_Rhizopus_oryzae	 Fungi; Fungi incertae sedis; Mucoromycota; Mucoromycotina; Mucoromycetes; Mucorales; Mucorineae; Rhizopodaceae; Rhizopus
Whelan2015_D10_Coeloplana_astericola	 Metazoa; Eumetazoa; Ctenophora; Tentaculata; Platyctenida; Coeloplanidae; Coeloplana
Whelan2015_D10_Periphylla_periphylla	 Metazoa; Eumetazoa; Cnidaria; Scyphozoa; Coronatae; Periphyllidae; Periphylla
Whelan2015_D10_Vallicula_sp	 Metazoa; Eumetazoa; Ctenophora; Tentaculata; Platyctenida; Coeloplanidae
Whelan2015_D10_Hormathia_digitata	 Metazoa; Eumetazoa; Cnidaria; Anthozoa; Hexacorallia; Actiniaria; Nynantheae; Hormathiidae; Hormathia
Whelan2015_D10_Hydra_oligactis	 Metazoa; Eumetazoa; Cnidaria; Hydrozoa; Hydroidolina; Anthoathecata; Aplanulata; Hydridae; Hydra
Whelan2015_D10_Mertensiidae_sp	 Metazoa; Eumetazoa; Ctenophora; Tentaculata; Cydippida; Mertensiidae; unclassified Mertensiidae
Whelan2015_D10_Pseudospongosorites_suberitoides	 Metazoa; Porifera; Demospongiae; Heteroscleromorpha; Suberitida; Suberitidae; Pseudospongosorites
Whelan2015_D10_Sycon_ciliatum	 Metazoa; Porifera; Calcarea; Calcaronea; Leucosolenida; Sycettidae; Sycon
Whelan2015_D10_Sycon_coactum	 Metazoa; Porifera; Calcarea; Calcaronea; Leucosolenida; Sycettidae; Sycon
Whelan2015_D10_Ircinia_fasciculata	 Metazoa; Porifera; Demospongiae; Keratosa; Dictyoceratida; Irciniidae; Sarcotragus
Whelan2015_D10_Spizellomyces_punctatus	 Fungi; Fungi incertae sedis; Chytridiomycota; Chytridiomycetes; Spizellomycetales; Spizellomycetaceae; Spizellomyces
Whelan2015_D10_Capsaspora_owczarzaki	 Opisthokonta incertae sedis; Ichthyosporea; Capsaspora
Whelan2015_D10_Aphrocallistes_vastus	 Metazoa; Porifera; Hexactinellida; Hexasterophora; Hexactinosida; Sceptrulophora; Aphrocallistidae; Aphrocallistes
Whelan2015_D10_Oscarella_carmela	 Metazoa; Porifera; Homoscleromorpha; Homosclerophorida; Plakinidae; Oscarella
Whelan2015_D10_Danio_rerio	 Metazoa; Eumetazoa; Bilateria; Deuterostomia; Chordata; Craniata; Vertebrata; Gnathostomata; Teleostomi; Euteleostomi; Actinopterygii; Actinopteri; Neopterygii; Teleostei; Osteoglossocephalai; Clupeocephala; Otomorpha; Ostariophysi; Otophysi; Cypriniphysae; Cypriniformes; Cyprinoidea; Cyprinidae; Danio
Whelan2015_D10_Craseoa_lathetica	 Metazoa; Eumetazoa; Cnidaria; Hydrozoa; Hydroidolina; Siphonophorae; Calycophorae; Prayidae; Prayinae; Craseoa
Whelan2015_D10_Nematostella_vectensis	 Metazoa; Eumetazoa; Cnidaria; Anthozoa; Hexacorallia; Actiniaria; Edwardsiidae; Nematostella
Whelan2015_D10_Saccoglossus_kowalevskii	 Metazoa; Eumetazoa; Bilateria; Deuterostomia; Hemichordata; Enteropneusta; Harrimaniidae; Saccoglossus
Whelan2015_D10_Priapulus_caudatus	 Metazoa; Eumetazoa; Bilateria; Protostomia; Ecdysozoa; Scalidophora; Priapulida; Priapulimorpha; Priapulimorphida; Priapulidae; Priapulus
Whelan2015_D20_Aurelia_aurita	 Metazoa; Eumetazoa; Cnidaria; Scyphozoa; Semaeostomeae; Ulmaridae; Aurelia
Whelan2015_D20_Lottia_gigantea	 Metazoa; Eumetazoa; Bilateria; Protostomia; Lophotrochozoa; Mollusca; Gastropoda; Patellogastropoda; Lottioidea; Lottiidae; Lottia
Whelan2015_D20_Sphaeroforma_arctica	 Opisthokonta incertae sedis; Ichthyosporea; Ichthyophonida; Sphaeroforma
Whelan2015_D20_Bolocera_tuediae	 Metazoa; Eumetazoa; Cnidaria; Anthozoa; Hexacorallia; Actiniaria; Actiniidae; Bolocera
Whelan2015_D20_Drosophila_melanogaster	 Metazoa; Eumetazoa; Bilateria; Protostomia; Ecdysozoa; Panarthropoda; Arthropoda; Mandibulata; Pancrustacea; Hexapoda; Insecta; Dicondylia; Pterygota; Neoptera; Holometabola; Diptera; Brachycera; Muscomorpha; Eremoneura; Cyclorrhapha; Schizophora; Acalyptratae; Ephydroidea; Drosophilidae; Drosophilinae; Drosophilini; Drosophila; Sophophora; melanogaster group; melanogaster subgroup
Whelan2015_D20_Rossella_fibulata	 Metazoa; Porifera; Hexactinellida; Hexasterophora; Lyssacinosida; Rossellidae; Rossella
Whelan2015_D20_Tubulanus_polymorphus	 Metazoa; Eumetazoa; Bilateria; Protostomia; Lophotrochozoa; Nemertea; Palaeonemertea; Tubulanidae; Tubulanus
Whelan2015_D20_Amoebidium_parasiticum	 Opisthokonta incertae sedis; Ichthyosporea; Ichthyophonida; Amoebidiaceae; Amoebidium
Whelan2015_D20_Abylopsis_tetragona	 Metazoa; Eumetazoa; Cnidaria; Hydrozoa; Hydroidolina; Siphonophorae; Calycophorae; Abylidae; Abylopsis
Whelan2015_D20_Eunicella_verrucosa	 Metazoa; Eumetazoa; Cnidaria; Anthozoa; Octocorallia; Alcyonacea; Holaxonia; Gorgoniidae; Eunicella
Whelan2015_D20_Dryodora_glandiformis	 Metazoa; Eumetazoa; Ctenophora; Tentaculata; Cydippida; Dryodoridae; Dryodora
Whelan2015_D20_Euplokamis_dunlapae	 Metazoa; Eumetazoa; Ctenophora; Tentaculata; Cydippida; Euplokamidae; Euplokamis
Whelan2015_D20_Lithobius_forficatus	 Metazoa; Eumetazoa; Bilateria; Protostomia; Ecdysozoa; Panarthropoda; Arthropoda; Mandibulata; Myriapoda; Chilopoda; Pleurostigmophora; Lithobiomorpha; Lithobiidae; Lithobius
Whelan2015_D20_Daphnia_pulex	 Metazoa; Eumetazoa; Bilateria; Protostomia; Ecdysozoa; Panarthropoda; Arthropoda; Mandibulata; Pancrustacea; Crustacea; Branchiopoda; Phyllopoda; Diplostraca; Cladocera; Anomopoda; Daphniidae; Daphnia
Whelan2015_D20_Pleurobrachia_pileus	 Metazoa; Eumetazoa; Ctenophora; Tentaculata; Cydippida; Pleurobrachiidae; Pleurobrachia
Whelan2015_D20_Aiptasia_pallida	 Metazoa; Eumetazoa; Cnidaria; Anthozoa; Hexacorallia; Actiniaria; Aiptasiidae; Exaiptasia
Whelan2015_D20_Mortierella_verticillata	 Fungi; Fungi incertae sedis; Mucoromycota; Mortierellomycotina; Mortierellomycetes; Mortierellales; Mortierellaceae; Mortierella
Whelan2015_D20_Homo_sapiens	 Metazoa; Eumetazoa; Bilateria; Deuterostomia; Chordata; Craniata; Vertebrata; Gnathostomata; Teleostomi; Euteleostomi; Sarcopterygii; Dipnotetrapodomorpha; Tetrapoda; Amniota; Mammalia; Theria; Eutheria; Boreoeutheria; Euarchontoglires; Primates; Haplorrhini; Simiiformes; Catarrhini; Hominoidea; Hominidae; Homininae; Homo
Whelan2015_D20_Amphimedon_queenslandica	 Metazoa; Porifera; Demospongiae; Heteroscleromorpha; Haplosclerida; Niphatidae; Amphimedon
Whelan2015_D20_Petrosia_ficiformis	 Metazoa; Porifera; Demospongiae; Heteroscleromorpha; Haplosclerida; Petrosiidae; Petrosia
Whelan2015_D20_Strongylocentrotus_purpuratus	 Metazoa; Eumetazoa; Bilateria; Deuterostomia; Echinodermata; Eleutherozoa; Echinozoa; Echinoidea; Euechinoidea; Echinacea; Echinoida; Strongylocentrotidae; Strongylocentrotus
Whelan2015_D20_Physalia_physalis	 Metazoa; Eumetazoa; Cnidaria; Hydrozoa; Hydroidolina; Siphonophorae; Cystonectae; Physaliidae; Physalia
Whelan2015_D20_Hydra_vulgaris	 Metazoa; Eumetazoa; Cnidaria; Hydrozoa; Hydroidolina; Anthoathecata; Aplanulata; Hydridae; Hydra
Whelan2015_D20_Corticium_candelabrum	 Metazoa; Porifera; Homoscleromorpha; Homosclerophorida; Plakinidae; Corticium
Whelan2015_D20_Nanomia_bijuga	 Metazoa; Eumetazoa; Cnidaria; Hydrozoa; Hydroidolina; Siphonophorae; Physonectae; Agalmatidae; Nanomia
Whelan2015_D20_Sympagella_nux	 Metazoa; Porifera; Hexactinellida; Hexasterophora; Lyssacinosida; Rossellidae; Sympagella
Whelan2015_D20_Spongilla_lacustris	 Metazoa; Porifera; Demospongiae; Heteroscleromorpha; Spongillida; Spongillidae; Spongilla
Whelan2015_D20_Monosiga_ovata	 Choanoflagellida; Craspedida; Salpingoecidae; Monosiga
Whelan2015_D20_Crella_elegans	 Metazoa; Porifera; Demospongiae; Heteroscleromorpha; Poecilosclerida; Crellidae; Crella
Whelan2015_D20_Ministeria_vibrans	 Opisthokonta incertae sedis; Ministeria
Whelan2015_D20_Mnemiopsis_leidyi	 Metazoa; Eumetazoa; Ctenophora; Tentaculata; Lobata; Bolinopsidae; Mnemiopsis
Whelan2015_D20_Petromyzon_marinus	 Metazoa; Eumetazoa; Bilateria; Deuterostomia; Chordata; Craniata; Vertebrata; Cyclostomata; Hyperoartia; Petromyzontiformes; Petromyzontidae; Petromyzon
Whelan2015_D20_Allomyces_macrogynus	 Fungi; Fungi incertae sedis; Blastocladiomycota; Blastocladiomycetes; Blastocladiales; Blastocladiaceae; Allomyces
Whelan2015_D20_Hemithiris_psittacea	 Metazoa; Eumetazoa; Bilateria; Protostomia; Lophotrochozoa; Brachiopoda; Rhynchonelliformea; Rhynchonellata; Rhynchonellida; Hemithiridoidea; Hemithyrididae; Hemithiris
Whelan2015_D20_Agalma_elegans	 Metazoa; Eumetazoa; Cnidaria; Hydrozoa; Hydroidolina; Siphonophorae; Physonectae; Agalmatidae; Agalma
Whelan2015_D20_Tethya_wilhelma	 Metazoa; Porifera; Demospongiae; Heteroscleromorpha; Tethyida; Tethyidae; Tethya
Whelan2015_D20_Bolinopsis_infundibulum	 Metazoa; Eumetazoa; Ctenophora; Tentaculata; Lobata; Bolinopsidae; Bolinopsis
Whelan2015_D20_Ephydatia_muelleri	 Metazoa; Porifera; Demospongiae; Heteroscleromorpha; Spongillida; Spongillidae; Ephydatia
Whelan2015_D20_Capitella_teleta	 Metazoa; Eumetazoa; Bilateria; Protostomia; Lophotrochozoa; Annelida; Polychaeta; Scolecida; Capitellida; Capitellidae; Capitella
Whelan2015_D20_Platygyra_carnosa	 Metazoa; Eumetazoa; Cnidaria; Anthozoa; Hexacorallia; Scleractinia; Faviina; Merulinidae; Platygyra
Whelan2015_D20_Salpingoeca_rosetta	 Choanoflagellida; Craspedida; Salpingoecidae; Salpingoeca
Whelan2015_D20_Chondrilla_nucula	 Metazoa; Porifera; Demospongiae; Verongimorpha; Chondrillida; Chondrillidae; Chondrilla
Whelan2015_D20_Trichoplax_adhaerens	 Metazoa; Placozoa; Trichoplacidae; Trichoplax
Whelan2015_D20_Pleurobrachia_bachei	 Metazoa; Eumetazoa; Ctenophora; Tentaculata; Cydippida; Pleurobrachiidae; Pleurobrachia
Whelan2015_D20_Beroe_abyssicola	 Metazoa; Eumetazoa; Ctenophora; Nuda; Beroida; Beroidae; Beroe
Whelan2015_D20_Hydra_viridissima	 Metazoa; Eumetazoa; Cnidaria; Hydrozoa; Hydroidolina; Anthoathecata; Aplanulata; Hydridae; Hydra
Whelan2015_D20_Acropora_digitifera	 Metazoa; Eumetazoa; Cnidaria; Anthozoa; Hexacorallia; Scleractinia; Astrocoeniina; Acroporidae; Acropora
Whelan2015_D20_Kirkpatrickia_variolosa	 Metazoa; Porifera; Demospongiae; Heteroscleromorpha; Poecilosclerida; Hymedesmiidae; Kirkpatrickia
Whelan2015_D20_Latrunculia_apicalis	 Metazoa; Porifera; Demospongiae; Heteroscleromorpha; Poecilosclerida; Latrunculiidae; Latrunculia
Whelan2015_D20_Hyalonema_populiferum	 Metazoa; Porifera; Hexactinellida; Amphidiscophora; Amphidiscosida; Hyalonematidae; Hyalonema
Whelan2015_D20_Rhizopus_oryzae	 Fungi; Fungi incertae sedis; Mucoromycota; Mucoromycotina; Mucoromycetes; Mucorales; Mucorineae; Rhizopodaceae; Rhizopus
Whelan2015_D20_Coeloplana_astericola	 Metazoa; Eumetazoa; Ctenophora; Tentaculata; Platyctenida; Coeloplanidae; Coeloplana
Whelan2015_D20_Periphylla_periphylla	 Metazoa; Eumetazoa; Cnidaria; Scyphozoa; Coronatae; Periphyllidae; Periphylla
Whelan2015_D20_Vallicula_sp	 Metazoa; Eumetazoa; Ctenophora; Tentaculata; Platyctenida; Coeloplanidae
Whelan2015_D20_Hormathia_digitata	 Metazoa; Eumetazoa; Cnidaria; Anthozoa; Hexacorallia; Actiniaria; Nynantheae; Hormathiidae; Hormathia
Whelan2015_D20_Hydra_oligactis	 Metazoa; Eumetazoa; Cnidaria; Hydrozoa; Hydroidolina; Anthoathecata; Aplanulata; Hydridae; Hydra
Whelan2015_D20_Mertensiidae_sp	 Metazoa; Eumetazoa; Ctenophora; Tentaculata; Cydippida; Mertensiidae; unclassified Mertensiidae
Whelan2015_D20_Pseudospongosorites_suberitoides	 Metazoa; Porifera; Demospongiae; Heteroscleromorpha; Suberitida; Suberitidae; Pseudospongosorites
Whelan2015_D20_Sycon_ciliatum	 Metazoa; Porifera; Calcarea; Calcaronea; Leucosolenida; Sycettidae; Sycon
Whelan2015_D20_Sycon_coactum	 Metazoa; Porifera; Calcarea; Calcaronea; Leucosolenida; Sycettidae; Sycon
Whelan2015_D20_Ircinia_fasciculata	 Metazoa; Porifera; Demospongiae; Keratosa; Dictyoceratida; Irciniidae; Sarcotragus
Whelan2015_D20_Spizellomyces_punctatus	 Fungi; Fungi incertae sedis; Chytridiomycota; Chytridiomycetes; Spizellomycetales; Spizellomycetaceae; Spizellomyces
Whelan2015_D20_Capsaspora_owczarzaki	 Opisthokonta incertae sedis; Ichthyosporea; Capsaspora
Whelan2015_D20_Aphrocallistes_vastus	 Metazoa; Porifera; Hexactinellida; Hexasterophora; Hexactinosida; Sceptrulophora; Aphrocallistidae; Aphrocallistes
Whelan2015_D20_Oscarella_carmela	 Metazoa; Porifera; Homoscleromorpha; Homosclerophorida; Plakinidae; Oscarella
Whelan2015_D20_Danio_rerio	 Metazoa; Eumetazoa; Bilateria; Deuterostomia; Chordata; Craniata; Vertebrata; Gnathostomata; Teleostomi; Euteleostomi; Actinopterygii; Actinopteri; Neopterygii; Teleostei; Osteoglossocephalai; Clupeocephala; Otomorpha; Ostariophysi; Otophysi; Cypriniphysae; Cypriniformes; Cyprinoidea; Cyprinidae; Danio
Whelan2015_D20_Craseoa_lathetica	 Metazoa; Eumetazoa; Cnidaria; Hydrozoa; Hydroidolina; Siphonophorae; Calycophorae; Prayidae; Prayinae; Craseoa
Whelan2015_D20_Nematostella_vectensis	 Metazoa; Eumetazoa; Cnidaria; Anthozoa; Hexacorallia; Actiniaria; Edwardsiidae; Nematostella
Whelan2015_D20_Saccoglossus_kowalevskii	 Metazoa; Eumetazoa; Bilateria; Deuterostomia; Hemichordata; Enteropneusta; Harrimaniidae; Saccoglossus
Whelan2015_D20_Priapulus_caudatus	 Metazoa; Eumetazoa; Bilateria; Protostomia; Ecdysozoa; Scalidophora; Priapulida; Priapulimorpha; Priapulimorphida; Priapulidae; Priapulus
Whelan2017_full_Beroe_sp_Antarctica	 Metazoa; Eumetazoa; Ctenophora; Nuda; Beroida; Beroidae
Whelan2017_full_Mertensiidae_sp_Washington_USA	 Metazoa; Eumetazoa; Ctenophora; Tentaculata; Cydippida; Mertensiidae; unclassified Mertensiidae
Whelan2017_full_Ctenophora_sp_Florida_USA	 Metazoa; Eumetazoa
Whelan2017_full_Sphaeroforma_arctica	 Opisthokonta incertae sedis; Ichthyosporea; Ichthyophonida; Sphaeroforma
Whelan2017_full_Bolocera_tuediae	 Metazoa; Eumetazoa; Cnidaria; Anthozoa; Hexacorallia; Actiniaria; Actiniidae; Bolocera
Whelan2017_full_Vallicula_sp	 Metazoa; Eumetazoa; Ctenophora; Tentaculata; Platyctenida; Coeloplanidae
Whelan2017_full_Drosophila_melanogaster	 Metazoa; Eumetazoa; Bilateria; Protostomia; Ecdysozoa; Panarthropoda; Arthropoda; Mandibulata; Pancrustacea; Hexapoda; Insecta; Dicondylia; Pterygota; Neoptera; Holometabola; Diptera; Brachycera; Muscomorpha; Eremoneura; Cyclorrhapha; Schizophora; Acalyptratae; Ephydroidea; Drosophilidae; Drosophilinae; Drosophilini; Drosophila; Sophophora; melanogaster group; melanogaster subgroup
Whelan2017_full_Ocyropsis_sp_Florida_USA	 Metazoa; Eumetazoa; Ctenophora; Tentaculata; Lobata; Ocyropsidae
Whelan2017_full_Rossella_fibulata	 Metazoa; Porifera; Hexactinellida; Hexasterophora; Lyssacinosida; Rossellidae; Rossella
Whelan2017_full_Amoebidium_parasiticum	 Opisthokonta incertae sedis; Ichthyosporea; Ichthyophonida; Amoebidiaceae; Amoebidium
Whelan2017_full_Abylopsis_tetragona	 Metazoa; Eumetazoa; Cnidaria; Hydrozoa; Hydroidolina; Siphonophorae; Calycophorae; Abylidae; Abylopsis
Whelan2017_full_Pleurobrachia_pileus	 Metazoa; Eumetazoa; Ctenophora; Tentaculata; Cydippida; Pleurobrachiidae; Pleurobrachia
Whelan2017_full_Ocyropsis_crystallina	 Metazoa; Eumetazoa; Ctenophora; Tentaculata; Lobata; Ocyropsidae; Ocyropsis
Whelan2017_full_Eunicella_verrucosa	 Metazoa; Eumetazoa; Cnidaria; Anthozoa; Octocorallia; Alcyonacea; Holaxonia; Gorgoniidae; Eunicella
Whelan2017_full_Dryodora_glandiformis	 Metazoa; Eumetazoa; Ctenophora; Tentaculata; Cydippida; Dryodoridae; Dryodora
Whelan2017_full_Euplokamis_dunlapae	 Metazoa; Eumetazoa; Ctenophora; Tentaculata; Cydippida; Euplokamidae; Euplokamis
Whelan2017_full_Daphnia_pulex	 Metazoa; Eumetazoa; Bilateria; Protostomia; Ecdysozoa; Panarthropoda; Arthropoda; Mandibulata; Pancrustacea; Crustacea; Branchiopoda; Phyllopoda; Diplostraca; Cladocera; Anomopoda; Daphniidae; Daphnia
Whelan2017_full_Eurhamphaea_vexilligera	 Metazoa; Eumetazoa; Ctenophora; Tentaculata; Lobata; Eurhamphaeidae; Eurhamphaea
Whelan2017_full_Aiptasia_pallida	 Metazoa; Eumetazoa; Cnidaria; Anthozoa; Hexacorallia; Actiniaria; Aiptasiidae; Exaiptasia
Whelan2017_full_Homo_sapiens	 Metazoa; Eumetazoa; Bilateria; Deuterostomia; Chordata; Craniata; Vertebrata; Gnathostomata; Teleostomi; Euteleostomi; Sarcopterygii; Dipnotetrapodomorpha; Tetrapoda; Amniota; Mammalia; Theria; Eutheria; Boreoeutheria; Euarchontoglires; Primates; Haplorrhini; Simiiformes; Catarrhini; Hominoidea; Hominidae; Homininae; Homo
Whelan2017_full_Amphimedon_queenslandica	 Metazoa; Porifera; Demospongiae; Heteroscleromorpha; Haplosclerida; Niphatidae; Amphimedon
Whelan2017_full_Petrosia_ficiformis	 Metazoa; Porifera; Demospongiae; Heteroscleromorpha; Haplosclerida; Petrosiidae; Petrosia
Whelan2017_full_Strongylocentrotus_purpuratus	 Metazoa; Eumetazoa; Bilateria; Deuterostomia; Echinodermata; Eleutherozoa; Echinozoa; Echinoidea; Euechinoidea; Echinacea; Echinoida; Strongylocentrotidae; Strongylocentrotus
Whelan2017_full_Physalia_physalis	 Metazoa; Eumetazoa; Cnidaria; Hydrozoa; Hydroidolina; Siphonophorae; Cystonectae; Physaliidae; Physalia
Whelan2017_full_Hydra_vulgaris	 Metazoa; Eumetazoa; Cnidaria; Hydrozoa; Hydroidolina; Anthoathecata; Aplanulata; Hydridae; Hydra
Whelan2017_full_Beroe_sp_Queensland_Australia	 Metazoa; Eumetazoa; Ctenophora; Nuda; Beroida; Beroidae
Whelan2017_full_Corticium_candelabrum	 Metazoa; Porifera; Homoscleromorpha; Homosclerophorida; Plakinidae; Corticium
Whelan2017_full_Beroe_forskalii	 Metazoa; Eumetazoa; Ctenophora; Nuda; Beroida; Beroidae; Beroe
Whelan2017_full_Nanomia_bijuga	 Metazoa; Eumetazoa; Cnidaria; Hydrozoa; Hydroidolina; Siphonophorae; Physonectae; Agalmatidae; Nanomia
Whelan2017_full_Lobata_sp_Punta_Arenas_Argentina	 Metazoa; Eumetazoa; Ctenophora; Tentaculata
Whelan2017_full_Acanthoeca_sp	 Choanoflagellida; Acanthoecida; Acanthoecidae
Whelan2017_full_Sycon_ciliatum	 Metazoa; Porifera; Calcarea; Calcaronea; Leucosolenida; Sycettidae; Sycon
Whelan2017_full_Sympagella_nux	 Metazoa; Porifera; Hexactinellida; Hexasterophora; Lyssacinosida; Rossellidae; Sympagella
Whelan2017_full_Spongilla_lacustris	 Metazoa; Porifera; Demospongiae; Heteroscleromorpha; Spongillida; Spongillidae; Spongilla
Whelan2017_full_Monosiga_ovata	 Choanoflagellida; Craspedida; Salpingoecidae; Monosiga
Whelan2017_full_Crella_elegans	 Metazoa; Porifera; Demospongiae; Heteroscleromorpha; Poecilosclerida; Crellidae; Crella
Whelan2017_full_Cydippida_sp_Maryland_USA	 Metazoa; Eumetazoa; Ctenophora; Tentaculata
Whelan2017_full_Ocyropsis_sp_Bimini_Bahamas	 Metazoa; Eumetazoa; Ctenophora; Tentaculata; Lobata; Ocyropsidae
Whelan2017_full_Ministeria_vibrans	 Opisthokonta incertae sedis; Ministeria
Whelan2017_full_Mnemiopsis_leidyi	 Metazoa; Eumetazoa; Ctenophora; Tentaculata; Lobata; Bolinopsidae; Mnemiopsis
Whelan2017_full_Mycale_phyllophila	 Metazoa; Porifera; Demospongiae; Heteroscleromorpha; Poecilosclerida; Mycalidae; Mycale
Whelan2017_full_Hemithiris_psittacea	 Metazoa; Eumetazoa; Bilateria; Protostomia; Lophotrochozoa; Brachiopoda; Rhynchonelliformea; Rhynchonellata; Rhynchonellida; Hemithiridoidea; Hemithyrididae; Hemithiris
Whelan2017_full_Callianira_Antarctica	 Metazoa; Eumetazoa; Ctenophora; Tentaculata; Cydippida; Mertensiidae; Callianira
Whelan2017_full_Agalma_elegans	 Metazoa; Eumetazoa; Cnidaria; Hydrozoa; Hydroidolina; Siphonophorae; Physonectae; Agalmatidae; Agalma
Whelan2017_full_Cestum_veneris	 Metazoa; Eumetazoa; Ctenophora; Tentaculata; Cestida; Cestidae; Cestum
Whelan2017_full_Cydippida_sp	 Metazoa; Eumetazoa; Ctenophora; Tentaculata
Whelan2017_full_Capitella_teleta	 Metazoa; Eumetazoa; Bilateria; Protostomia; Lophotrochozoa; Annelida; Polychaeta; Scolecida; Capitellida; Capitellidae; Capitella
Whelan2017_full_Salpingoeca_pyxidium	 Choanoflagellida; Craspedida; Salpingoecidae; Salpingoeca
Whelan2017_full_Salpingoeca_rosetta	 Choanoflagellida; Craspedida; Salpingoecidae; Salpingoeca
Whelan2017_full_Chondrilla_nucula	 Metazoa; Porifera; Demospongiae; Verongimorpha; Chondrillida; Chondrillidae; Chondrilla
Whelan2017_full_Trichoplax_adhaerens	 Metazoa; Placozoa; Trichoplacidae; Trichoplax
Whelan2017_full_Pleurobrachia_bachei	 Metazoa; Eumetazoa; Ctenophora; Tentaculata; Cydippida; Pleurobrachiidae; Pleurobrachia
Whelan2017_full_Monosiga_brevicollis	 Choanoflagellida; Craspedida; Salpingoecidae; Monosiga
Whelan2017_full_Lobatolampea_tetragona	 Metazoa; Eumetazoa; Ctenophora; Tentaculata; Lobata; Lobatolampeidae; Lobatolampea
Whelan2017_full_Beroe_abyssicola	 Metazoa; Eumetazoa; Ctenophora; Nuda; Beroida; Beroidae; Beroe
Whelan2017_full_Capsaspora_owczarzaki	 Opisthokonta incertae sedis; Ichthyosporea; Capsaspora
Whelan2017_full_Hydra_viridissima	 Metazoa; Eumetazoa; Cnidaria; Hydrozoa; Hydroidolina; Anthoathecata; Aplanulata; Hydridae; Hydra
Whelan2017_full_Acropora_digitifera	 Metazoa; Eumetazoa; Cnidaria; Anthozoa; Hexacorallia; Scleractinia; Astrocoeniina; Acroporidae; Acropora
Whelan2017_full_Bolinopsis_infundibulum	 Metazoa; Eumetazoa; Ctenophora; Tentaculata; Lobata; Bolinopsidae; Bolinopsis
Whelan2017_full_Cliona_varians	 Metazoa; Porifera; Demospongiae; Heteroscleromorpha; Clionaida; Clionaidae; Cliona
Whelan2017_full_Kirkpatrickia_variolosa	 Metazoa; Porifera; Demospongiae; Heteroscleromorpha; Poecilosclerida; Hymedesmiidae; Kirkpatrickia
Whelan2017_full_Latrunculia_apicalis	 Metazoa; Porifera; Demospongiae; Heteroscleromorpha; Poecilosclerida; Latrunculiidae; Latrunculia
Whelan2017_full_Hormiphora_palmata	 Metazoa; Eumetazoa; Ctenophora; Tentaculata; Cydippida; Pleurobrachiidae; Hormiphora
Whelan2017_full_Hyalonema_populiferum	 Metazoa; Porifera; Hexactinellida; Amphidiscophora; Amphidiscosida; Hyalonematidae; Hyalonema
Whelan2017_full_Coeloplana_astericola	 Metazoa; Eumetazoa; Ctenophora; Tentaculata; Platyctenida; Coeloplanidae; Coeloplana
Whelan2017_full_Periphylla_periphylla	 Metazoa; Eumetazoa; Cnidaria; Scyphozoa; Coronatae; Periphyllidae; Periphylla
Whelan2017_full_Mertensiidae_sp_Antarctica	 Metazoa; Eumetazoa; Ctenophora; Tentaculata; Cydippida; Mertensiidae; unclassified Mertensiidae
Whelan2017_full_Hormathia_digitata	 Metazoa; Eumetazoa; Cnidaria; Anthozoa; Hexacorallia; Actiniaria; Nynantheae; Hormathiidae; Hormathia
Whelan2017_full_Hydra_oligactis	 Metazoa; Eumetazoa; Cnidaria; Hydrozoa; Hydroidolina; Anthoathecata; Aplanulata; Hydridae; Hydra
Whelan2017_full_Pseudospongosorites_suberitoides	 Metazoa; Porifera; Demospongiae; Heteroscleromorpha; Suberitida; Suberitidae; Pseudospongosorites
Whelan2017_full_Sycon_coactum	 Metazoa; Porifera; Calcarea; Calcaronea; Leucosolenida; Sycettidae; Sycon
Whelan2017_full_Ircinia_fasciculata	 Metazoa; Porifera; Demospongiae; Keratosa; Dictyoceratida; Irciniidae; Sarcotragus
Whelan2017_full_Bolinopsis_ashleyi	 Metazoa; Eumetazoa; Ctenophora; Tentaculata; Lobata; Bolinopsidae; Bolinopsis
Whelan2017_full_Pleurobrachia_sp_South_Carolina_USA	 Metazoa; Eumetazoa; Ctenophora; Tentaculata; Cydippida; Pleurobrachiidae
Whelan2017_full_Aphrocallistes_vastus	 Metazoa; Porifera; Hexactinellida; Hexasterophora; Hexactinosida; Sceptrulophora; Aphrocallistidae; Aphrocallistes
Whelan2017_full_Oscarella_carmela	 Metazoa; Porifera; Homoscleromorpha; Homosclerophorida; Plakinidae; Oscarella
Whelan2017_full_Beroe_ovata	 Metazoa; Eumetazoa; Ctenophora; Nuda; Beroida; Beroidae; Beroe
Whelan2017_full_Craseoa_lathetica	 Metazoa; Eumetazoa; Cnidaria; Hydrozoa; Hydroidolina; Siphonophorae; Calycophorae; Prayidae; Prayinae; Craseoa
Whelan2017_full_Nematostella_vectensis	 Metazoa; Eumetazoa; Cnidaria; Anthozoa; Hexacorallia; Actiniaria; Edwardsiidae; Nematostella
Whelan2017_full_Hormiphora_californensis	 Metazoa; Eumetazoa; Ctenophora; Tentaculata; Cydippida; Pleurobrachiidae; Hormiphora
Whelan2017_strict_Beroe_sp_Antarctica	 Metazoa; Eumetazoa; Ctenophora; Nuda; Beroida; Beroidae
Whelan2017_strict_Mertensiidae_sp_Washington_USA	 Metazoa; Eumetazoa; Ctenophora; Tentaculata; Cydippida; Mertensiidae; unclassified Mertensiidae
Whelan2017_strict_Ctenophora_sp_Florida_USA	 Metazoa; Eumetazoa
Whelan2017_strict_Bolocera_tuediae	 Metazoa; Eumetazoa; Cnidaria; Anthozoa; Hexacorallia; Actiniaria; Actiniidae; Bolocera
Whelan2017_strict_Vallicula_sp	 Metazoa; Eumetazoa; Ctenophora; Tentaculata; Platyctenida; Coeloplanidae
Whelan2017_strict_Drosophila_melanogaster	 Metazoa; Eumetazoa; Bilateria; Protostomia; Ecdysozoa; Panarthropoda; Arthropoda; Mandibulata; Pancrustacea; Hexapoda; Insecta; Dicondylia; Pterygota; Neoptera; Holometabola; Diptera; Brachycera; Muscomorpha; Eremoneura; Cyclorrhapha; Schizophora; Acalyptratae; Ephydroidea; Drosophilidae; Drosophilinae; Drosophilini; Drosophila; Sophophora; melanogaster group; melanogaster subgroup
Whelan2017_strict_Ocyropsis_sp_Florida_USA	 Metazoa; Eumetazoa; Ctenophora; Tentaculata; Lobata; Ocyropsidae
Whelan2017_strict_Rossella_fibulata	 Metazoa; Porifera; Hexactinellida; Hexasterophora; Lyssacinosida; Rossellidae; Rossella
Whelan2017_strict_Abylopsis_tetragona	 Metazoa; Eumetazoa; Cnidaria; Hydrozoa; Hydroidolina; Siphonophorae; Calycophorae; Abylidae; Abylopsis
Whelan2017_strict_Pleurobrachia_pileus	 Metazoa; Eumetazoa; Ctenophora; Tentaculata; Cydippida; Pleurobrachiidae; Pleurobrachia
Whelan2017_strict_Ocyropsis_crystallina	 Metazoa; Eumetazoa; Ctenophora; Tentaculata; Lobata; Ocyropsidae; Ocyropsis
Whelan2017_strict_Eunicella_verrucosa	 Metazoa; Eumetazoa; Cnidaria; Anthozoa; Octocorallia; Alcyonacea; Holaxonia; Gorgoniidae; Eunicella
Whelan2017_strict_Dryodora_glandiformis	 Metazoa; Eumetazoa; Ctenophora; Tentaculata; Cydippida; Dryodoridae; Dryodora
Whelan2017_strict_Euplokamis_dunlapae	 Metazoa; Eumetazoa; Ctenophora; Tentaculata; Cydippida; Euplokamidae; Euplokamis
Whelan2017_strict_Daphnia_pulex	 Metazoa; Eumetazoa; Bilateria; Protostomia; Ecdysozoa; Panarthropoda; Arthropoda; Mandibulata; Pancrustacea; Crustacea; Branchiopoda; Phyllopoda; Diplostraca; Cladocera; Anomopoda; Daphniidae; Daphnia
Whelan2017_strict_Eurhamphaea_vexilligera	 Metazoa; Eumetazoa; Ctenophora; Tentaculata; Lobata; Eurhamphaeidae; Eurhamphaea
Whelan2017_strict_Aiptasia_pallida	 Metazoa; Eumetazoa; Cnidaria; Anthozoa; Hexacorallia; Actiniaria; Aiptasiidae; Exaiptasia
Whelan2017_strict_Homo_sapiens	 Metazoa; Eumetazoa; Bilateria; Deuterostomia; Chordata; Craniata; Vertebrata; Gnathostomata; Teleostomi; Euteleostomi; Sarcopterygii; Dipnotetrapodomorpha; Tetrapoda; Amniota; Mammalia; Theria; Eutheria; Boreoeutheria; Euarchontoglires; Primates; Haplorrhini; Simiiformes; Catarrhini; Hominoidea; Hominidae; Homininae; Homo
Whelan2017_strict_Amphimedon_queenslandica	 Metazoa; Porifera; Demospongiae; Heteroscleromorpha; Haplosclerida; Niphatidae; Amphimedon
Whelan2017_strict_Petrosia_ficiformis	 Metazoa; Porifera; Demospongiae; Heteroscleromorpha; Haplosclerida; Petrosiidae; Petrosia
Whelan2017_strict_Strongylocentrotus_purpuratus	 Metazoa; Eumetazoa; Bilateria; Deuterostomia; Echinodermata; Eleutherozoa; Echinozoa; Echinoidea; Euechinoidea; Echinacea; Echinoida; Strongylocentrotidae; Strongylocentrotus
Whelan2017_strict_Physalia_physalis	 Metazoa; Eumetazoa; Cnidaria; Hydrozoa; Hydroidolina; Siphonophorae; Cystonectae; Physaliidae; Physalia
Whelan2017_strict_Hydra_vulgaris	 Metazoa; Eumetazoa; Cnidaria; Hydrozoa; Hydroidolina; Anthoathecata; Aplanulata; Hydridae; Hydra
Whelan2017_strict_Beroe_sp_Queensland_Australia	 Metazoa; Eumetazoa; Ctenophora; Nuda; Beroida; Beroidae
Whelan2017_strict_Corticium_candelabrum	 Metazoa; Porifera; Homoscleromorpha; Homosclerophorida; Plakinidae; Corticium
Whelan2017_strict_Beroe_forskalii	 Metazoa; Eumetazoa; Ctenophora; Nuda; Beroida; Beroidae; Beroe
Whelan2017_strict_Nanomia_bijuga	 Metazoa; Eumetazoa; Cnidaria; Hydrozoa; Hydroidolina; Siphonophorae; Physonectae; Agalmatidae; Nanomia
Whelan2017_strict_Lobata_sp_Punta_Arenas_Argentina	 Metazoa; Eumetazoa; Ctenophora; Tentaculata
Whelan2017_strict_Acanthoeca_sp	 Choanoflagellida; Acanthoecida; Acanthoecidae
Whelan2017_strict_Sycon_ciliatum	 Metazoa; Porifera; Calcarea; Calcaronea; Leucosolenida; Sycettidae; Sycon
Whelan2017_strict_Sympagella_nux	 Metazoa; Porifera; Hexactinellida; Hexasterophora; Lyssacinosida; Rossellidae; Sympagella
Whelan2017_strict_Spongilla_lacustris	 Metazoa; Porifera; Demospongiae; Heteroscleromorpha; Spongillida; Spongillidae; Spongilla
Whelan2017_strict_Monosiga_ovata	 Choanoflagellida; Craspedida; Salpingoecidae; Monosiga
Whelan2017_strict_Crella_elegans	 Metazoa; Porifera; Demospongiae; Heteroscleromorpha; Poecilosclerida; Crellidae; Crella
Whelan2017_strict_Cydippida_sp_Maryland_USA	 Metazoa; Eumetazoa; Ctenophora; Tentaculata
Whelan2017_strict_Ocyropsis_sp_Bimini_Bahamas	 Metazoa; Eumetazoa; Ctenophora; Tentaculata; Lobata; Ocyropsidae
Whelan2017_strict_Mnemiopsis_leidyi	 Metazoa; Eumetazoa; Ctenophora; Tentaculata; Lobata; Bolinopsidae; Mnemiopsis
Whelan2017_strict_Mycale_phyllophila	 Metazoa; Porifera; Demospongiae; Heteroscleromorpha; Poecilosclerida; Mycalidae; Mycale
Whelan2017_strict_Hemithiris_psittacea	 Metazoa; Eumetazoa; Bilateria; Protostomia; Lophotrochozoa; Brachiopoda; Rhynchonelliformea; Rhynchonellata; Rhynchonellida; Hemithiridoidea; Hemithyrididae; Hemithiris
Whelan2017_strict_Callianira_Antarctica	 Metazoa; Eumetazoa; Ctenophora; Tentaculata; Cydippida; Mertensiidae; Callianira
Whelan2017_strict_Agalma_elegans	 Metazoa; Eumetazoa; Cnidaria; Hydrozoa; Hydroidolina; Siphonophorae; Physonectae; Agalmatidae; Agalma
Whelan2017_strict_Cestum_veneris	 Metazoa; Eumetazoa; Ctenophora; Tentaculata; Cestida; Cestidae; Cestum
Whelan2017_strict_Cydippida_sp	 Metazoa; Eumetazoa; Ctenophora; Tentaculata
Whelan2017_strict_Capitella_teleta	 Metazoa; Eumetazoa; Bilateria; Protostomia; Lophotrochozoa; Annelida; Polychaeta; Scolecida; Capitellida; Capitellidae; Capitella
Whelan2017_strict_Salpingoeca_pyxidium	 Choanoflagellida; Craspedida; Salpingoecidae; Salpingoeca
Whelan2017_strict_Salpingoeca_rosetta	 Choanoflagellida; Craspedida; Salpingoecidae; Salpingoeca
Whelan2017_strict_Chondrilla_nucula	 Metazoa; Porifera; Demospongiae; Verongimorpha; Chondrillida; Chondrillidae; Chondrilla
Whelan2017_strict_Trichoplax_adhaerens	 Metazoa; Placozoa; Trichoplacidae; Trichoplax
Whelan2017_strict_Pleurobrachia_bachei	 Metazoa; Eumetazoa; Ctenophora; Tentaculata; Cydippida; Pleurobrachiidae; Pleurobrachia
Whelan2017_strict_Monosiga_brevicollis	 Choanoflagellida; Craspedida; Salpingoecidae; Monosiga
Whelan2017_strict_Lobatolampea_tetragona	 Metazoa; Eumetazoa; Ctenophora; Tentaculata; Lobata; Lobatolampeidae; Lobatolampea
Whelan2017_strict_Beroe_abyssicola	 Metazoa; Eumetazoa; Ctenophora; Nuda; Beroida; Beroidae; Beroe
Whelan2017_strict_Hydra_viridissima	 Metazoa; Eumetazoa; Cnidaria; Hydrozoa; Hydroidolina; Anthoathecata; Aplanulata; Hydridae; Hydra
Whelan2017_strict_Acropora_digitifera	 Metazoa; Eumetazoa; Cnidaria; Anthozoa; Hexacorallia; Scleractinia; Astrocoeniina; Acroporidae; Acropora
Whelan2017_strict_Bolinopsis_infundibulum	 Metazoa; Eumetazoa; Ctenophora; Tentaculata; Lobata; Bolinopsidae; Bolinopsis
Whelan2017_strict_Cliona_varians	 Metazoa; Porifera; Demospongiae; Heteroscleromorpha; Clionaida; Clionaidae; Cliona
Whelan2017_strict_Kirkpatrickia_variolosa	 Metazoa; Porifera; Demospongiae; Heteroscleromorpha; Poecilosclerida; Hymedesmiidae; Kirkpatrickia
Whelan2017_strict_Latrunculia_apicalis	 Metazoa; Porifera; Demospongiae; Heteroscleromorpha; Poecilosclerida; Latrunculiidae; Latrunculia
Whelan2017_strict_Hormiphora_palmata	 Metazoa; Eumetazoa; Ctenophora; Tentaculata; Cydippida; Pleurobrachiidae; Hormiphora
Whelan2017_strict_Hyalonema_populiferum	 Metazoa; Porifera; Hexactinellida; Amphidiscophora; Amphidiscosida; Hyalonematidae; Hyalonema
Whelan2017_strict_Coeloplana_astericola	 Metazoa; Eumetazoa; Ctenophora; Tentaculata; Platyctenida; Coeloplanidae; Coeloplana
Whelan2017_strict_Periphylla_periphylla	 Metazoa; Eumetazoa; Cnidaria; Scyphozoa; Coronatae; Periphyllidae; Periphylla
Whelan2017_strict_Mertensiidae_sp_Antarctica	 Metazoa; Eumetazoa; Ctenophora; Tentaculata; Cydippida; Mertensiidae; unclassified Mertensiidae
Whelan2017_strict_Hormathia_digitata	 Metazoa; Eumetazoa; Cnidaria; Anthozoa; Hexacorallia; Actiniaria; Nynantheae; Hormathiidae; Hormathia
Whelan2017_strict_Hydra_oligactis	 Metazoa; Eumetazoa; Cnidaria; Hydrozoa; Hydroidolina; Anthoathecata; Aplanulata; Hydridae; Hydra
Whelan2017_strict_Pseudospongosorites_suberitoides	 Metazoa; Porifera; Demospongiae; Heteroscleromorpha; Suberitida; Suberitidae; Pseudospongosorites
Whelan2017_strict_Sycon_coactum	 Metazoa; Porifera; Calcarea; Calcaronea; Leucosolenida; Sycettidae; Sycon
Whelan2017_strict_Ircinia_fasciculata	 Metazoa; Porifera; Demospongiae; Keratosa; Dictyoceratida; Irciniidae; Sarcotragus
Whelan2017_strict_Bolinopsis_ashleyi	 Metazoa; Eumetazoa; Ctenophora; Tentaculata; Lobata; Bolinopsidae; Bolinopsis
Whelan2017_strict_Pleurobrachia_sp_South_Carolina_USA	 Metazoa; Eumetazoa; Ctenophora; Tentaculata; Cydippida; Pleurobrachiidae
Whelan2017_strict_Aphrocallistes_vastus	 Metazoa; Porifera; Hexactinellida; Hexasterophora; Hexactinosida; Sceptrulophora; Aphrocallistidae; Aphrocallistes
Whelan2017_strict_Oscarella_carmela	 Metazoa; Porifera; Homoscleromorpha; Homosclerophorida; Plakinidae; Oscarella
Whelan2017_strict_Beroe_ovata	 Metazoa; Eumetazoa; Ctenophora; Nuda; Beroida; Beroidae; Beroe
Whelan2017_strict_Craseoa_lathetica	 Metazoa; Eumetazoa; Cnidaria; Hydrozoa; Hydroidolina; Siphonophorae; Calycophorae; Prayidae; Prayinae; Craseoa
Whelan2017_strict_Nematostella_vectensis	 Metazoa; Eumetazoa; Cnidaria; Anthozoa; Hexacorallia; Actiniaria; Edwardsiidae; Nematostella
Whelan2017_strict_Hormiphora_californensis	 Metazoa; Eumetazoa; Ctenophora; Tentaculata; Cydippida; Pleurobrachiidae; Hormiphora
dosReisDonoghueYang_2015_superalignment_Amphimedon_queenslandica	 Metazoa; Porifera; Demospongiae; Heteroscleromorpha; Haplosclerida; Niphatidae; Amphimedon
dosReisDonoghueYang_2015_superalignment_Suberites_domuncula	 Metazoa; Porifera; Demospongiae; Heteroscleromorpha; Suberitida; Suberitidae; Suberites
dosReisDonoghueYang_2015_superalignment_Trichoplax_adhaerens	 Metazoa; Placozoa; Trichoplacidae; Trichoplax
dosReisDonoghueYang_2015_superalignment_Acropora_millepora	 Metazoa; Eumetazoa; Cnidaria; Anthozoa; Hexacorallia; Scleractinia; Astrocoeniina; Acroporidae; Acropora
dosReisDonoghueYang_2015_superalignment_Anemonia_viridis	 Metazoa; Eumetazoa; Cnidaria; Anthozoa; Hexacorallia; Actiniaria; Actiniidae; Anemonia
dosReisDonoghueYang_2015_superalignment_Nematostella_vectensis	 Metazoa; Eumetazoa; Cnidaria; Anthozoa; Hexacorallia; Actiniaria; Edwardsiidae; Nematostella
dosReisDonoghueYang_2015_superalignment_Hydra_magnipapillata	 Metazoa; Eumetazoa; Cnidaria; Hydrozoa; Hydroidolina; Anthoathecata; Aplanulata; Hydridae; Hydra
dosReisDonoghueYang_2015_superalignment_Hydractinia_echinata	 Metazoa; Eumetazoa; Cnidaria; Hydrozoa; Hydroidolina; Anthoathecata; Filifera; Hydractiniidae; Hydractinia
dosReisDonoghueYang_2015_superalignment_Branchiostoma_floridae	 Metazoa; Eumetazoa; Bilateria; Deuterostomia; Chordata; Cephalochordata; Branchiostomidae; Branchiostoma
dosReisDonoghueYang_2015_superalignment_Ciona_intestinalis	 Metazoa; Eumetazoa; Bilateria; Deuterostomia; Chordata; Tunicata; Ascidiacea; Enterogona; Phlebobranchia; Cionidae; Ciona
dosReisDonoghueYang_2015_superalignment_Molgula_tectiformis	 Metazoa; Eumetazoa; Bilateria; Deuterostomia; Chordata; Tunicata; Ascidiacea; Stolidobranchia; Molgulidae; Molgula
dosReisDonoghueYang_2015_superalignment_Danio_rerio	 Metazoa; Eumetazoa; Bilateria; Deuterostomia; Chordata; Craniata; Vertebrata; Gnathostomata; Teleostomi; Euteleostomi; Actinopterygii; Actinopteri; Neopterygii; Teleostei; Osteoglossocephalai; Clupeocephala; Otomorpha; Ostariophysi; Otophysi; Cypriniphysae; Cypriniformes; Cyprinoidea; Cyprinidae; Danio
dosReisDonoghueYang_2015_superalignment_Gallus_gallus	 Metazoa; Eumetazoa; Bilateria; Deuterostomia; Chordata; Craniata; Vertebrata; Gnathostomata; Teleostomi; Euteleostomi; Sarcopterygii; Dipnotetrapodomorpha; Tetrapoda; Amniota; Sauropsida; Sauria; Archelosauria; Archosauria; Dinosauria; Saurischia; Theropoda; Coelurosauria; Aves; Neognathae; Galloanserae; Galliformes; Phasianidae; Phasianinae; Gallus
dosReisDonoghueYang_2015_superalignment_Homo_sapiens	 Metazoa; Eumetazoa; Bilateria; Deuterostomia; Chordata; Craniata; Vertebrata; Gnathostomata; Teleostomi; Euteleostomi; Sarcopterygii; Dipnotetrapodomorpha; Tetrapoda; Amniota; Mammalia; Theria; Eutheria; Boreoeutheria; Euarchontoglires; Primates; Haplorrhini; Simiiformes; Catarrhini; Hominoidea; Hominidae; Homininae; Homo
dosReisDonoghueYang_2015_superalignment_Xenopus_tropicalis	 Metazoa; Eumetazoa; Bilateria; Deuterostomia; Chordata; Craniata; Vertebrata; Gnathostomata; Teleostomi; Euteleostomi; Sarcopterygii; Dipnotetrapodomorpha; Tetrapoda; Amphibia; Batrachia; Anura; Pipoidea; Pipidae; Xenopodinae; Xenopus; Silurana
dosReisDonoghueYang_2015_superalignment_Petromyzon_marinus	 Metazoa; Eumetazoa; Bilateria; Deuterostomia; Chordata; Craniata; Vertebrata; Cyclostomata; Hyperoartia; Petromyzontiformes; Petromyzontidae; Petromyzon
dosReisDonoghueYang_2015_superalignment_Strongylocentrotus_purpuratus	 Metazoa; Eumetazoa; Bilateria; Deuterostomia; Echinodermata; Eleutherozoa; Echinozoa; Echinoidea; Euechinoidea; Echinacea; Echinoida; Strongylocentrotidae; Strongylocentrotus
dosReisDonoghueYang_2015_superalignment_Ptychodera_flava	 Metazoa; Eumetazoa; Bilateria; Deuterostomia; Hemichordata; Enteropneusta; Ptychoderidae; Ptychodera
dosReisDonoghueYang_2015_superalignment_Saccoglossus_kowalevskii	 Metazoa; Eumetazoa; Bilateria; Deuterostomia; Hemichordata; Enteropneusta; Harrimaniidae; Saccoglossus
dosReisDonoghueYang_2015_superalignment_Symsagittifera_roscoffensis	 Metazoa; Eumetazoa; Bilateria; Xenacoelomorpha; Acoelomorpha; Acoela; Sagittiferidae; Symsagittifera
dosReisDonoghueYang_2015_superalignment_Xenoturbella_bocki	 Metazoa; Eumetazoa; Bilateria; Xenacoelomorpha; Xenoturbellida; Xenoturbellidae; Xenoturbella
dosReisDonoghueYang_2015_superalignment_Capitella_teleta	 Metazoa; Eumetazoa; Bilateria; Protostomia; Lophotrochozoa; Annelida; Polychaeta; Scolecida; Capitellida; Capitellidae; Capitella
dosReisDonoghueYang_2015_superalignment_Helobdella_robusta	 Metazoa; Eumetazoa; Bilateria; Protostomia; Lophotrochozoa; Annelida; Clitellata; Hirudinea; Hirudinida; Glossiphoniiformes; Glossiphoniidae; Helobdella
dosReisDonoghueYang_2015_superalignment_Tubifex_tubifex	 Metazoa; Eumetazoa; Bilateria; Protostomia; Lophotrochozoa; Annelida; Clitellata; Oligochaeta; Haplotaxida; Tubificina; Naididae; Tubificinae; Tubifex
dosReisDonoghueYang_2015_superalignment_Aplysia_californica	 Metazoa; Eumetazoa; Bilateria; Protostomia; Lophotrochozoa; Mollusca; Gastropoda; Heterobranchia; Euthyneura; Euopisthobranchia; Aplysiida; Aplysioidea; Aplysiidae; Aplysia
dosReisDonoghueYang_2015_superalignment_Lottia_gigantea	 Metazoa; Eumetazoa; Bilateria; Protostomia; Lophotrochozoa; Mollusca; Gastropoda; Patellogastropoda; Lottioidea; Lottiidae; Lottia
dosReisDonoghueYang_2015_superalignment_Crassostrea_virginica	 Metazoa; Eumetazoa; Bilateria; Protostomia; Lophotrochozoa; Mollusca; Bivalvia; Pteriomorphia; Ostreoida; Ostreoidea; Ostreidae; Crassostrea
dosReisDonoghueYang_2015_superalignment_Mytilus_galloprovincialis	 Metazoa; Eumetazoa; Bilateria; Protostomia; Lophotrochozoa; Mollusca; Bivalvia; Pteriomorphia; Mytiloida; Mytiloidea; Mytilidae; Mytilinae; Mytilus
dosReisDonoghueYang_2015_superalignment_Euprymna_scolopes	 Metazoa; Eumetazoa; Bilateria; Protostomia; Lophotrochozoa; Mollusca; Cephalopoda; Coleoidea; Neocoleoidea; Decapodiformes; Sepiolida; Sepiolidae; Sepiolinae; Euprymna
dosReisDonoghueYang_2015_superalignment_Brachionus_plicatilis	 Metazoa; Eumetazoa; Bilateria; Protostomia; Lophotrochozoa; Rotifera; Monogononta; Pseudotrocha; Ploima; Brachionidae; Brachionus
dosReisDonoghueYang_2015_superalignment_Philodina_roseola	 Metazoa; Eumetazoa; Bilateria; Protostomia; Lophotrochozoa; Rotifera; Bdelloidea; Philodinida; Philodinidae; Philodina
dosReisDonoghueYang_2015_superalignment_Flaccisagitta_enflata	 Metazoa; Eumetazoa; Bilateria; Deuterostomia; Chaetognatha; Sagittoidea; Aphragmophora; Ctenodontina; Sagittidae; Flaccisagitta
dosReisDonoghueYang_2015_superalignment_Spadella_cephaloptera	 Metazoa; Eumetazoa; Bilateria; Deuterostomia; Chaetognatha; Sagittoidea; Phragmophora; Spadellidae; Spadella
dosReisDonoghueYang_2015_superalignment_Priapulus_caudatus	 Metazoa; Eumetazoa; Bilateria; Protostomia; Ecdysozoa; Scalidophora; Priapulida; Priapulimorpha; Priapulimorphida; Priapulidae; Priapulus
dosReisDonoghueYang_2015_superalignment_Caenorhabditis_elegans	 Metazoa; Eumetazoa; Bilateria; Protostomia; Ecdysozoa; Nematoda; Chromadorea; Rhabditida; Rhabditina; Rhabditomorpha; Rhabditoidea; Rhabditidae; Peloderinae; Caenorhabditis
dosReisDonoghueYang_2015_superalignment_Euperipatoides_kanangrensis	 Metazoa; Eumetazoa; Bilateria; Protostomia; Ecdysozoa; Panarthropoda; Onychophora; Udeonychophora; Euonychophora; Peripatopsidae; Euperipatoides
dosReisDonoghueYang_2015_superalignment_Daphnia_pulex	 Metazoa; Eumetazoa; Bilateria; Protostomia; Ecdysozoa; Panarthropoda; Arthropoda; Mandibulata; Pancrustacea; Crustacea; Branchiopoda; Phyllopoda; Diplostraca; Cladocera; Anomopoda; Daphniidae; Daphnia
dosReisDonoghueYang_2015_superalignment_Rhodnius_prolixus	 Metazoa; Eumetazoa; Bilateria; Protostomia; Ecdysozoa; Panarthropoda; Arthropoda; Mandibulata; Pancrustacea; Hexapoda; Insecta; Dicondylia; Pterygota; Neoptera; Paraneoptera; Hemiptera; Prosorrhyncha; Heteroptera; Euheteroptera; Neoheteroptera; Panheteroptera; Cimicomorpha; Reduvioidea; Reduviidae; Triatominae; Rhodnius
dosReisDonoghueYang_2015_superalignment_Tribolium_castaneum	 Metazoa; Eumetazoa; Bilateria; Protostomia; Ecdysozoa; Panarthropoda; Arthropoda; Mandibulata; Pancrustacea; Hexapoda; Insecta; Dicondylia; Pterygota; Neoptera; Holometabola; Coleoptera; Polyphaga; Cucujiformia; Tenebrionoidea; Tenebrionidae; Tenebrionidae incertae sedis; Tribolium
dosReisDonoghueYang_2015_superalignment_Onychiurus_arcticus	 Metazoa; Eumetazoa; Bilateria; Protostomia; Ecdysozoa; Panarthropoda; Arthropoda; Mandibulata; Pancrustacea; Hexapoda; Collembola; Poduromorpha; Poduroidea; Onychiuridae; Onychiurinae; Megaphorura
dosReisDonoghueYang_2015_superalignment_Scutigera_coleoptrata	 Metazoa; Eumetazoa; Bilateria; Protostomia; Ecdysozoa; Panarthropoda; Arthropoda; Mandibulata; Myriapoda; Chilopoda; Notostigmophora; Scutigeromorpha; Scutigeridae; Scutigera
dosReisDonoghueYang_2015_superalignment_Anoplodactylus_eroticus	 Metazoa; Eumetazoa; Bilateria; Protostomia; Ecdysozoa; Panarthropoda; Arthropoda; Chelicerata; Pycnogonida; Pantopoda; Phoxichilidiidae; Anoplodactylus
dosReisDonoghueYang_2015_superalignment_Acanthoscurria_gomesiana	 Metazoa; Eumetazoa; Bilateria; Protostomia; Ecdysozoa; Panarthropoda; Arthropoda; Chelicerata; Arachnida; Araneae; Mygalomorphae; Theraphosidae; Acanthoscurria
dosReisDonoghueYang_2015_superalignment_Ixodes_scapularis	 Metazoa; Eumetazoa; Bilateria; Protostomia; Ecdysozoa; Panarthropoda; Arthropoda; Chelicerata; Arachnida; Acari; Parasitiformes; Ixodida; Ixodoidea; Ixodidae; Ixodinae; Ixodes
dosReisDonoghueYang_2015_superalignment_Mus_musculus	Metazoa; Eumetazoa; Bilateria; Deuterostomia; Chordata; Craniata; Vertebrata; Gnathostomata; Teleostomi; Euteleostomi; Sarcopterygii; Dipnotetrapodomorpha; Tetrapoda; Amniota; Mammalia; Theria; Eutheria; Boreoeutheria; Euarchontoglires; Glires; Rodentia; Myomorpha; Muroidea; Muridae; Murinae; Mus; Mus
dosReisDonoghueYang_2015_superalignment_Ornithorhynchus_anatinus	Metazoa; Eumetazoa; Bilateria; Deuterostomia; Chordata; Craniata; Vertebrata; Gnathostomata; Teleostomi; Euteleostomi; Sarcopterygii; Dipnotetrapodomorpha; Tetrapoda; Amniota; Mammalia; Prototheria; Monotremata; Ornithorhynchidae; Ornithorhynchus
dosReisDonoghueYang_2015_superalignment_Leucoraja	Metazoa; Eumetazoa; Bilateria; Deuterostomia; Chordata; Craniata; Vertebrata; Gnathostomata; Chondrichthyes; Elasmobranchii; Batoidea; Rajiformes; Rajidae
dosReisDonoghueYang_2015_superalignment_Eptatretus	    Metazoa; Eumetazoa; Bilateria; Deuterostomia; Chordata; Craniata; Vertebrata; Cyclostomata; Myxini; Myxiniformes; Myxinidae; Eptatretinae
dosReisDonoghueYang_2015_superalignment_Patiria_pectinifera	    Metazoa; Eumetazoa; Bilateria; Deuterostomia; Echinodermata; Eleutherozoa; Asterozoa; Asteroidea; Valvatacea; Valvatida; Asterinidae; Patiria
dosReisDonoghueYang_2015_superalignment_Holothuria	Metazoa; Eumetazoa; Bilateria; Deuterostomia; Echinodermata; Eleutherozoa; Echinozoa; Holothuroidea; Aspidochirotacea; Aspidochirotida; Holothuriidae
dosReisDonoghueYang_2015_superalignment_Alvinella	Metazoa; Eumetazoa; Bilateria; Protostomia; Spiralia; Lophotrochozoa; Annelida; Polychaeta; Sedentaria; Canalipalpata; Terebellida; Terebelliformia; Alvinellidae
dosReisDonoghueYang_2015_superalignment_Pomatoceros	Metazoa; Eumetazoa; Bilateria; Protostomia; Spiralia; Lophotrochozoa; Annelida; Polychaeta; Sedentaria; Canalipalpata; Sabellida; Serpulidae
dosReisDonoghueYang_2015_superalignment_Gryllus_bimaculatus	Metazoa; Eumetazoa; Bilateria; Protostomia; Ecdysozoa; Panarthropoda; Arthropoda; Mandibulata; Pancrustacea; Hexapoda; Insecta; Dicondylia; Pterygota; Neoptera; Polyneoptera; Orthoptera; Ensifera; Gryllidea; Grylloidea; Gryllidae; Gryllinae; Gryllus